Group,Affilitation,Year,Vaccine,Target,Vaccinated,Coverage,Unvaccinated
"GVAP Indicator",gavi,1980,bcg,60819406,5984684,10,54834722
"GVAP Indicator",gavi,1981,bcg,61932455,9963715,16,51968740
"GVAP Indicator",gavi,1982,bcg,63007070,10880661,17,52126409
"GVAP Indicator",gavi,1983,bcg,64018091,13158247,21,50859844
"GVAP Indicator",gavi,1984,bcg,64951407,16087102,25,48864305
"GVAP Indicator",gavi,1985,bcg,65798020,19000447,29,46797573
"GVAP Indicator",gavi,1986,bcg,66558466,21445900,32,45112566
"GVAP Indicator",gavi,1987,bcg,67250897,28320691,42,38930206
"GVAP Indicator",gavi,1988,bcg,67893755,30896402,46,36997353
"GVAP Indicator",gavi,1989,bcg,68497416,35998361,53,32499055
"GVAP Indicator",gavi,1990,bcg,69071284,50030245,72,19041039
"GVAP Indicator",gavi,1991,bcg,69622880,46525952,67,23096928
"GVAP Indicator",gavi,1992,bcg,72214522,49620171,69,22594351
"GVAP Indicator",gavi,1993,bcg,72797731,51335616,71,21462115
"GVAP Indicator",gavi,1994,bcg,73255184,52936132,72,20319052
"GVAP Indicator",gavi,1995,bcg,73722619,55772941,76,17949678
"GVAP Indicator",gavi,1996,bcg,74209895,54882683,74,19327212
"GVAP Indicator",gavi,1997,bcg,74719497,52681906,71,22037591
"GVAP Indicator",gavi,1998,bcg,75252862,54125913,72,21126949
"GVAP Indicator",gavi,1999,bcg,75812471,55515315,73,20297156
"GVAP Indicator",gavi,2000,bcg,76403441,56460304,74,19943137
"GVAP Indicator",gavi,2001,bcg,77029300,57235823,74,19793477
"GVAP Indicator",gavi,2002,bcg,77720635,58025571,75,19695064
"GVAP Indicator",gavi,2003,bcg,78387064,59443535,76,18943529
"GVAP Indicator",gavi,2004,bcg,79053825,61615521,78,17438304
"GVAP Indicator",gavi,2005,bcg,79697635,64541023,81,15156612
"GVAP Indicator",gavi,2006,bcg,80293190,65791823,82,14501367
"GVAP Indicator",gavi,2007,bcg,80827141,66911822,83,13915319
"GVAP Indicator",gavi,2008,bcg,81294778,67667091,83,13627687
"GVAP Indicator",gavi,2009,bcg,81698999,69517731,85,12181268
"GVAP Indicator",gavi,2010,bcg,82054790,70138464,85,11916326
"GVAP Indicator",gavi,2011,bcg,82385952,70595922,86,11790030
"GVAP Indicator",gavi,2012,bcg,82719609,70665368,85,12054241
"GVAP Indicator",gavi,2013,bcg,83075961,70116400,84,12959561
"GVAP Indicator",gavi,2014,bcg,83462528,69812308,84,13650220
"GVAP Indicator",gavi,2015,bcg,83878573,69617659,83,14260914
"GVAP Indicator",gavi,2016,bcg,84314625,70912495,84,13402130
"GVAP Indicator",gavi,2017,bcg,84752207,72282742,85,12469465
"GVAP Indicator",gavi,1980,dtp1,53963378,9059938,17,44903440
"GVAP Indicator",gavi,1981,dtp1,55096834,12802867,23,42293967
"GVAP Indicator",gavi,1982,dtp1,56194883,15587728,28,40607155
"GVAP Indicator",gavi,1983,dtp1,57234982,18364090,32,38870892
"GVAP Indicator",gavi,1984,dtp1,58203625,22488212,39,35715413
"GVAP Indicator",gavi,1985,dtp1,59091070,26587667,45,32503403
"GVAP Indicator",gavi,1986,dtp1,59896096,30034480,50,29861616
"GVAP Indicator",gavi,1987,dtp1,60634879,35076490,58,25558389
"GVAP Indicator",gavi,1988,dtp1,61324812,39822199,65,21502613
"GVAP Indicator",gavi,1989,dtp1,61976611,45520261,73,16456350
"GVAP Indicator",gavi,1990,dtp1,62600835,51657443,83,10943392
"GVAP Indicator",gavi,1991,dtp1,63206753,48371645,77,14835108
"GVAP Indicator",gavi,1992,dtp1,65754684,50106446,76,15648238
"GVAP Indicator",gavi,1993,dtp1,66399480,50997597,77,15401883
"GVAP Indicator",gavi,1994,dtp1,66939294,53880806,80,13058488
"GVAP Indicator",gavi,1995,dtp1,67498445,54819563,81,12678882
"GVAP Indicator",gavi,1996,dtp1,68086709,54215608,80,13871101
"GVAP Indicator",gavi,1997,dtp1,68705104,54536094,79,14169010
"GVAP Indicator",gavi,1998,dtp1,69353352,52425416,76,16927936
"GVAP Indicator",gavi,1999,dtp1,70032540,51116691,73,18915849
"GVAP Indicator",gavi,2000,dtp1,70746374,51931751,73,18814623
"GVAP Indicator",gavi,2001,dtp1,71497127,52986168,74,18510959
"GVAP Indicator",gavi,2002,dtp1,72311931,53751697,74,18560234
"GVAP Indicator",gavi,2003,dtp1,73104660,55624961,76,17479699
"GVAP Indicator",gavi,2004,dtp1,73896934,57416146,78,16480788
"GVAP Indicator",gavi,2005,dtp1,74665309,59513047,80,15152262
"GVAP Indicator",gavi,2006,dtp1,75384977,60354577,80,15030400
"GVAP Indicator",gavi,2007,dtp1,76043087,61566523,81,14476564
"GVAP Indicator",gavi,2008,dtp1,76634785,62909879,82,13724906
"GVAP Indicator",gavi,2009,dtp1,77162051,65161538,84,12000513
"GVAP Indicator",gavi,2010,dtp1,77638415,65391584,84,12246831
"GVAP Indicator",gavi,2011,dtp1,78086066,67129518,86,10956548
"GVAP Indicator",gavi,2012,dtp1,78530916,67055916,85,11475000
"GVAP Indicator",gavi,2013,dtp1,78992372,66720723,84,12271649
"GVAP Indicator",gavi,2014,dtp1,79477574,67610041,85,11867533
"GVAP Indicator",gavi,2015,dtp1,79985890,68444211,86,11541679
"GVAP Indicator",gavi,2016,dtp1,80508460,68932229,86,11576231
"GVAP Indicator",gavi,2017,dtp1,81028147,69534102,86,11494045
"GVAP Indicator",gavi,1980,dtp3,53963378,2905806,5,51057572
"GVAP Indicator",gavi,1981,dtp3,55096834,4116169,7,50980665
"GVAP Indicator",gavi,1982,dtp3,56194883,5967977,11,50226906
"GVAP Indicator",gavi,1983,dtp3,57234982,7609906,13,49625076
"GVAP Indicator",gavi,1984,dtp3,58203625,10056871,17,48146754
"GVAP Indicator",gavi,1985,dtp3,59091070,13343190,23,45747880
"GVAP Indicator",gavi,1986,dtp3,59896096,16312203,27,43583893
"GVAP Indicator",gavi,1987,dtp3,60634879,20933696,35,39701183
"GVAP Indicator",gavi,1988,dtp3,61324812,25579070,42,35745742
"GVAP Indicator",gavi,1989,dtp3,61976611,31624994,51,30351617
"GVAP Indicator",gavi,1990,dtp3,62600835,39924325,64,22676510
"GVAP Indicator",gavi,1991,dtp3,63206753,35056411,55,28150342
"GVAP Indicator",gavi,1992,dtp3,65754684,36297743,55,29456941
"GVAP Indicator",gavi,1993,dtp3,66399480,37791896,57,28607584
"GVAP Indicator",gavi,1994,dtp3,66939294,41308081,62,25631213
"GVAP Indicator",gavi,1995,dtp3,67498445,43054514,64,24443931
"GVAP Indicator",gavi,1996,dtp3,68086709,41677042,61,26409667
"GVAP Indicator",gavi,1997,dtp3,68705104,40928826,60,27776278
"GVAP Indicator",gavi,1998,dtp3,69353352,41304881,60,28048471
"GVAP Indicator",gavi,1999,dtp3,70032540,41122698,59,28909842
"GVAP Indicator",gavi,2000,dtp3,70746374,42267176,60,28479198
"GVAP Indicator",gavi,2001,dtp3,71497127,43243469,60,28253658
"GVAP Indicator",gavi,2002,dtp3,72311931,43569076,60,28742855
"GVAP Indicator",gavi,2003,dtp3,73104660,46091353,63,27013307
"GVAP Indicator",gavi,2004,dtp3,73896934,48646887,66,25250047
"GVAP Indicator",gavi,2005,dtp3,74665309,50131114,67,24534195
"GVAP Indicator",gavi,2006,dtp3,75384977,51146861,68,24238116
"GVAP Indicator",gavi,2007,dtp3,76043087,52164192,69,23878895
"GVAP Indicator",gavi,2008,dtp3,76634785,55061359,72,21573426
"GVAP Indicator",gavi,2009,dtp3,77162051,57517392,75,19644659
"GVAP Indicator",gavi,2010,dtp3,77638415,58805861,76,18832554
"GVAP Indicator",gavi,2011,dtp3,78086066,60409278,77,17676788
"GVAP Indicator",gavi,2012,dtp3,78530916,60633375,77,17897541
"GVAP Indicator",gavi,2013,dtp3,78992372,60384659,76,18607713
"GVAP Indicator",gavi,2014,dtp3,79477574,61925444,78,17552130
"GVAP Indicator",gavi,2015,dtp3,79985890,63256655,79,16729235
"GVAP Indicator",gavi,2016,dtp3,80508460,64116911,80,16391549
"GVAP Indicator",gavi,2017,dtp3,81028147,64616150,80,16411997
"GVAP Indicator",gavi,1985,hepb3,59091070,0,0,59091070
"GVAP Indicator",gavi,1986,hepb3,59896096,0,0,59896096
"GVAP Indicator",gavi,1987,hepb3,60634879,0,0,60634879
"GVAP Indicator",gavi,1988,hepb3,61324812,0,0,61324812
"GVAP Indicator",gavi,1989,hepb3,61976611,0,0,61976611
"GVAP Indicator",gavi,1990,hepb3,62600835,29941,0,62570894
"GVAP Indicator",gavi,1991,hepb3,63206753,70558,0,63136195
"GVAP Indicator",gavi,1992,hepb3,65754684,1263695,2,64490989
"GVAP Indicator",gavi,1993,hepb3,66399480,2077712,3,64321768
"GVAP Indicator",gavi,1994,hepb3,66939294,2063880,3,64875414
"GVAP Indicator",gavi,1995,hepb3,67498445,2440298,4,65058147
"GVAP Indicator",gavi,1996,hepb3,68086709,3052672,4,65034037
"GVAP Indicator",gavi,1997,hepb3,68705104,3222364,5,65482740
"GVAP Indicator",gavi,1998,hepb3,69353352,3751116,5,65602236
"GVAP Indicator",gavi,1999,hepb3,70032540,4048378,6,65984162
"GVAP Indicator",gavi,2000,hepb3,70746374,4268616,6,66477758
"GVAP Indicator",gavi,2001,hepb3,71497127,4521132,6,66975995
"GVAP Indicator",gavi,2002,hepb3,72311931,10179325,14,62132606
"GVAP Indicator",gavi,2003,hepb3,73104660,16014626,22,57090034
"GVAP Indicator",gavi,2004,hepb3,73896934,20072480,27,53824454
"GVAP Indicator",gavi,2005,hepb3,74665309,25537074,34,49128235
"GVAP Indicator",gavi,2006,hepb3,75384977,28846736,38,46538241
"GVAP Indicator",gavi,2007,hepb3,76043087,35401565,47,40641522
"GVAP Indicator",gavi,2008,hepb3,76634785,42658185,56,33976600
"GVAP Indicator",gavi,2009,hepb3,77162051,47619660,62,29542391
"GVAP Indicator",gavi,2010,hepb3,77638415,47576513,61,30061902
"GVAP Indicator",gavi,2011,hepb3,78086066,49795833,64,28290233
"GVAP Indicator",gavi,2012,hepb3,78530916,57464566,73,21066350
"GVAP Indicator",gavi,2013,hepb3,78992372,57011720,72,21980652
"GVAP Indicator",gavi,2014,hepb3,79477574,60327757,76,19149817
"GVAP Indicator",gavi,2015,hepb3,79985890,63241625,79,16744265
"GVAP Indicator",gavi,2016,hepb3,80508460,64140673,80,16367787
"GVAP Indicator",gavi,2017,hepb3,81028147,64595580,80,16432567
"GVAP Indicator",gavi,2000,hepbb,76442800,320085,0,76122715
"GVAP Indicator",gavi,2001,hepbb,77068234,552474,1,76515760
"GVAP Indicator",gavi,2002,hepbb,77720635,1513542,2,76207093
"GVAP Indicator",gavi,2003,hepbb,78387064,1694112,2,76692952
"GVAP Indicator",gavi,2004,hepbb,79053825,2069657,3,76984168
"GVAP Indicator",gavi,2005,hepbb,79697635,2077127,3,77620508
"GVAP Indicator",gavi,2006,hepbb,80293190,2157158,3,78136032
"GVAP Indicator",gavi,2007,hepbb,80827141,2875903,4,77951238
"GVAP Indicator",gavi,2008,hepbb,81294778,5711101,7,75583677
"GVAP Indicator",gavi,2009,hepbb,81698999,6584657,8,75114342
"GVAP Indicator",gavi,2010,hepbb,82054790,6604579,8,75450211
"GVAP Indicator",gavi,2011,hepbb,82385952,7466024,9,74919928
"GVAP Indicator",gavi,2012,hepbb,82719609,11743044,14,70976565
"GVAP Indicator",gavi,2013,hepbb,83075961,15042778,18,68033183
"GVAP Indicator",gavi,2014,hepbb,83462528,16202766,19,67259762
"GVAP Indicator",gavi,2015,hepbb,83878573,17389680,21,66488893
"GVAP Indicator",gavi,2016,hepbb,84314625,18355253,22,65959372
"GVAP Indicator",gavi,2017,hepbb,84752207,21799429,26,62952778
"GVAP Indicator",gavi,1990,hib3,62600835,0,0,62600835
"GVAP Indicator",gavi,1991,hib3,63206753,0,0,63206753
"GVAP Indicator",gavi,1992,hib3,65754684,0,0,65754684
"GVAP Indicator",gavi,1993,hib3,66399480,0,0,66399480
"GVAP Indicator",gavi,1994,hib3,66939294,0,0,66939294
"GVAP Indicator",gavi,1995,hib3,67498445,0,0,67498445
"GVAP Indicator",gavi,1996,hib3,68086709,0,0,68086709
"GVAP Indicator",gavi,1997,hib3,68705104,0,0,68705104
"GVAP Indicator",gavi,1998,hib3,69353352,48233,0,69305119
"GVAP Indicator",gavi,1999,hib3,70032540,299275,0,69733265
"GVAP Indicator",gavi,2000,hib3,70746374,675210,1,70071164
"GVAP Indicator",gavi,2001,hib3,71497127,696712,1,70800415
"GVAP Indicator",gavi,2002,hib3,72311931,3138285,4,69173646
"GVAP Indicator",gavi,2003,hib3,73104660,3360026,5,69744634
"GVAP Indicator",gavi,2004,hib3,73896934,4275174,6,69621760
"GVAP Indicator",gavi,2005,hib3,74665309,5018064,7,69647245
"GVAP Indicator",gavi,2006,hib3,75384977,6438353,9,68946624
"GVAP Indicator",gavi,2007,hib3,76043087,9192707,12,66850380
"GVAP Indicator",gavi,2008,hib3,76634785,12268019,16,64366766
"GVAP Indicator",gavi,2009,hib3,77162051,26181227,34,50980824
"GVAP Indicator",gavi,2010,hib3,77638415,28729236,37,48909179
"GVAP Indicator",gavi,2011,hib3,78086066,30953145,40,47132921
"GVAP Indicator",gavi,2012,hib3,78530916,32772358,42,45758558
"GVAP Indicator",gavi,2013,hib3,78992372,39957448,51,39034924
"GVAP Indicator",gavi,2014,hib3,79477574,43696781,55,35780793
"GVAP Indicator",gavi,2015,hib3,79985890,53123499,66,26862391
"GVAP Indicator",gavi,2016,hib3,80508460,62324132,77,18184328
"GVAP Indicator",gavi,2017,hib3,81028147,64547924,80,16480223
"GVAP Indicator",gavi,2015,ipv1,79375126,10268519,13,69106607
"GVAP Indicator",gavi,2016,ipv1,79899643,30858921,39,49040722
"GVAP Indicator",gavi,2017,ipv1,80420365,35052175,44,45368190
"GVAP Indicator",gavi,1980,mcv1,53963378,1302032,2,52661346
"GVAP Indicator",gavi,1981,mcv1,55096834,2299278,4,52797556
"GVAP Indicator",gavi,1982,mcv1,56194883,2847717,5,53347166
"GVAP Indicator",gavi,1983,mcv1,57234982,4286033,7,52948949
"GVAP Indicator",gavi,1984,mcv1,58203625,6379228,11,51824397
"GVAP Indicator",gavi,1985,mcv1,59091070,9173983,16,49917087
"GVAP Indicator",gavi,1986,mcv1,59896096,14615260,24,45280836
"GVAP Indicator",gavi,1987,mcv1,60634879,19557944,32,41076935
"GVAP Indicator",gavi,1988,mcv1,61324812,24279539,40,37045273
"GVAP Indicator",gavi,1989,mcv1,61976611,30497252,49,31479359
"GVAP Indicator",gavi,1990,mcv1,62600835,35877188,57,26723647
"GVAP Indicator",gavi,1991,mcv1,63206753,32354452,51,30852301
"GVAP Indicator",gavi,1992,mcv1,65754684,35870537,55,29884147
"GVAP Indicator",gavi,1993,mcv1,66399480,38818188,58,27581292
"GVAP Indicator",gavi,1994,mcv1,66939294,42118592,63,24820702
"GVAP Indicator",gavi,1995,mcv1,67498445,43480246,64,24018199
"GVAP Indicator",gavi,1996,mcv1,68086709,42736720,63,25349989
"GVAP Indicator",gavi,1997,mcv1,68705104,40146489,58,28558615
"GVAP Indicator",gavi,1998,mcv1,69353352,39815115,57,29538237
"GVAP Indicator",gavi,1999,mcv1,70032540,40857153,58,29175387
"GVAP Indicator",gavi,2000,mcv1,70746374,41924300,59,28822074
"GVAP Indicator",gavi,2001,mcv1,71497127,42970707,60,28526420
"GVAP Indicator",gavi,2002,mcv1,72311931,43268845,60,29043086
"GVAP Indicator",gavi,2003,mcv1,73104660,45834858,63,27269802
"GVAP Indicator",gavi,2004,mcv1,73896934,48489955,66,25406979
"GVAP Indicator",gavi,2005,mcv1,74665309,50707474,68,23957835
"GVAP Indicator",gavi,2006,mcv1,75384977,51984525,69,23400452
"GVAP Indicator",gavi,2007,mcv1,76043087,53242108,70,22800979
"GVAP Indicator",gavi,2008,mcv1,76634785,54958595,72,21676190
"GVAP Indicator",gavi,2009,mcv1,77162051,58254743,75,18907308
"GVAP Indicator",gavi,2010,mcv1,77638415,59872859,77,17765556
"GVAP Indicator",gavi,2011,mcv1,78086066,60443024,77,17643042
"GVAP Indicator",gavi,2012,mcv1,78530916,60386898,77,18144018
"GVAP Indicator",gavi,2013,mcv1,78992372,60698810,77,18293562
"GVAP Indicator",gavi,2014,mcv1,79477574,61205760,77,18271814
"GVAP Indicator",gavi,2015,mcv1,79985890,62500868,78,17485022
"GVAP Indicator",gavi,2016,mcv1,80508460,62958135,78,17550325
"GVAP Indicator",gavi,2017,mcv1,81028147,63621055,79,17407092
"GVAP Indicator",gavi,2000,mcv2,67772447,1396015,2,66376432
"GVAP Indicator",gavi,2001,mcv2,68700343,1659299,2,67041044
"GVAP Indicator",gavi,2002,mcv2,69628030,1817849,3,67810181
"GVAP Indicator",gavi,2003,mcv2,69957580,2750595,4,67206985
"GVAP Indicator",gavi,2004,mcv2,70763982,3190021,5,67573961
"GVAP Indicator",gavi,2005,mcv2,71526068,3084010,4,68442058
"GVAP Indicator",gavi,2006,mcv2,72394238,4404958,6,67989280
"GVAP Indicator",gavi,2007,mcv2,73077595,5501029,8,67576566
"GVAP Indicator",gavi,2008,mcv2,73659835,7304531,10,66355304
"GVAP Indicator",gavi,2009,mcv2,74382180,8615122,12,65767058
"GVAP Indicator",gavi,2010,mcv2,75044200,9441253,13,65602947
"GVAP Indicator",gavi,2011,mcv2,75987277,16985505,22,59001772
"GVAP Indicator",gavi,2012,mcv2,76721811,20509330,27,56212481
"GVAP Indicator",gavi,2013,mcv2,76664496,26498625,35,50165871
"GVAP Indicator",gavi,2014,mcv2,77140836,28201852,37,48938984
"GVAP Indicator",gavi,2015,mcv2,77653986,32976281,42,44677705
"GVAP Indicator",gavi,2016,mcv2,78019446,38392110,49,39627336
"GVAP Indicator",gavi,2017,mcv2,78406655,40183820,51,38222835
"GVAP Indicator",gavi,2000,mcv2x2,67641636,599187,1,67042449
"GVAP Indicator",gavi,2001,mcv2x2,68573722,604397,1,67969325
"GVAP Indicator",gavi,2002,mcv2x2,69512062,574847,1,68937215
"GVAP Indicator",gavi,2003,mcv2x2,69811437,578207,1,69233230
"GVAP Indicator",gavi,2004,mcv2x2,70609672,90074,0,70519598
"GVAP Indicator",gavi,2005,mcv2x2,71421249,304167,0,71117082
"GVAP Indicator",gavi,2006,mcv2x2,72385114,439009,1,71946105
"GVAP Indicator",gavi,2007,mcv2x2,73306655,350694,0,72955961
"GVAP Indicator",gavi,2008,mcv2x2,73889995,1520452,2,72369543
"GVAP Indicator",gavi,2009,mcv2x2,74674779,2931470,4,71743309
"GVAP Indicator",gavi,2010,mcv2x2,75398276,3194613,4,72203663
"GVAP Indicator",gavi,2011,mcv2x2,76220341,11976395,16,64243946
"GVAP Indicator",gavi,2012,mcv2x2,76956037,15012910,20,61943127
"GVAP Indicator",gavi,2013,mcv2x2,76980067,21063097,27,55916970
"GVAP Indicator",gavi,2014,mcv2x2,77456476,24978657,32,52477819
"GVAP Indicator",gavi,2015,mcv2x2,77943122,29575434,38,48367688
"GVAP Indicator",gavi,2016,mcv2x2,78309170,33948163,43,44361007
"GVAP Indicator",gavi,2017,mcv2x2,78658580,35042627,45,43615953
"GVAP Indicator",gavi,2008,pcv3,76634785,0,0,76634785
"GVAP Indicator",gavi,2009,pcv3,77162051,0,0,77162051
"GVAP Indicator",gavi,2010,pcv3,77638415,400883,1,77237532
"GVAP Indicator",gavi,2011,pcv3,78086066,3683871,5,74402195
"GVAP Indicator",gavi,2012,pcv3,78530916,6631022,8,71899894
"GVAP Indicator",gavi,2013,pcv3,78992372,14851030,19,64141342
"GVAP Indicator",gavi,2014,pcv3,79477574,21727534,27,57750040
"GVAP Indicator",gavi,2015,pcv3,79985890,28962294,36,51023596
"GVAP Indicator",gavi,2016,pcv3,80508460,33191311,41,47317149
"GVAP Indicator",gavi,2017,pcv3,81028147,34751811,43,46276336
"GVAP Indicator",gavi,1980,pol3,53963378,2105518,4,51857860
"GVAP Indicator",gavi,1981,pol3,55096834,2885605,5,52211229
"GVAP Indicator",gavi,1982,pol3,56194883,4844324,9,51350559
"GVAP Indicator",gavi,1983,pol3,57234982,6270779,11,50964203
"GVAP Indicator",gavi,1984,pol3,58203625,8421167,14,49782458
"GVAP Indicator",gavi,1985,pol3,59091070,11930252,20,47160818
"GVAP Indicator",gavi,1986,pol3,59896096,15224743,25,44671353
"GVAP Indicator",gavi,1987,pol3,60634879,19920552,33,40714327
"GVAP Indicator",gavi,1988,pol3,61324812,24331994,40,36992818
"GVAP Indicator",gavi,1989,pol3,61976611,32333663,52,29642948
"GVAP Indicator",gavi,1990,pol3,62600835,39017848,62,23582987
"GVAP Indicator",gavi,1991,pol3,63206753,35579786,56,27626967
"GVAP Indicator",gavi,1992,pol3,65754684,36408959,55,29345725
"GVAP Indicator",gavi,1993,pol3,66399480,37817387,57,28582093
"GVAP Indicator",gavi,1994,pol3,66939294,41575315,62,25363979
"GVAP Indicator",gavi,1995,pol3,67498445,43345860,64,24152585
"GVAP Indicator",gavi,1996,pol3,68086709,42931967,63,25154742
"GVAP Indicator",gavi,1997,pol3,68705104,42437401,62,26267703
"GVAP Indicator",gavi,1998,pol3,69353352,42361253,61,26992099
"GVAP Indicator",gavi,1999,pol3,70032540,42515893,61,27516647
"GVAP Indicator",gavi,2000,pol3,70746374,42898184,61,27848190
"GVAP Indicator",gavi,2001,pol3,71497127,44164464,62,27332663
"GVAP Indicator",gavi,2002,pol3,72311931,45745561,63,26566370
"GVAP Indicator",gavi,2003,pol3,73104660,47098454,64,26006206
"GVAP Indicator",gavi,2004,pol3,73896934,48415718,66,25481216
"GVAP Indicator",gavi,2005,pol3,74665309,51512083,69,23153226
"GVAP Indicator",gavi,2006,pol3,75384977,52392048,69,22992929
"GVAP Indicator",gavi,2007,pol3,76043087,54213066,71,21830021
"GVAP Indicator",gavi,2008,pol3,76634785,55754944,73,20879841
"GVAP Indicator",gavi,2009,pol3,77162051,58325503,76,18836548
"GVAP Indicator",gavi,2010,pol3,77638415,58843838,76,18794577
"GVAP Indicator",gavi,2011,pol3,78086066,59736808,77,18349258
"GVAP Indicator",gavi,2012,pol3,78530916,60174185,77,18356731
"GVAP Indicator",gavi,2013,pol3,78992372,60655848,77,18336524
"GVAP Indicator",gavi,2014,pol3,79477574,61647330,78,17830244
"GVAP Indicator",gavi,2015,pol3,79985890,62918012,79,17067878
"GVAP Indicator",gavi,2016,pol3,80508460,63118241,78,17390219
"GVAP Indicator",gavi,2017,pol3,81028147,64106868,79,16921279
"GVAP Indicator",gavi,1980,rcv1,53963378,0,0,53963378
"GVAP Indicator",gavi,1981,rcv1,55096834,0,0,55096834
"GVAP Indicator",gavi,1982,rcv1,56194883,0,0,56194883
"GVAP Indicator",gavi,1983,rcv1,57234982,0,0,57234982
"GVAP Indicator",gavi,1984,rcv1,58203625,0,0,58203625
"GVAP Indicator",gavi,1985,rcv1,59091070,0,0,59091070
"GVAP Indicator",gavi,1986,rcv1,59896096,140346,0,59755750
"GVAP Indicator",gavi,1987,rcv1,60634879,175657,0,60459222
"GVAP Indicator",gavi,1988,rcv1,61324812,158448,0,61166364
"GVAP Indicator",gavi,1989,rcv1,61976611,173587,0,61803024
"GVAP Indicator",gavi,1990,rcv1,62600835,164380,0,62436455
"GVAP Indicator",gavi,1991,rcv1,63206753,169921,0,63036832
"GVAP Indicator",gavi,1992,rcv1,65754684,166336,0,65588348
"GVAP Indicator",gavi,1993,rcv1,66399480,157907,0,66241573
"GVAP Indicator",gavi,1994,rcv1,66939294,159628,0,66779666
"GVAP Indicator",gavi,1995,rcv1,67498445,172231,0,67326214
"GVAP Indicator",gavi,1996,rcv1,68086709,472920,1,67613789
"GVAP Indicator",gavi,1997,rcv1,68705104,660136,1,68044968
"GVAP Indicator",gavi,1998,rcv1,69353352,805850,1,68547502
"GVAP Indicator",gavi,1999,rcv1,70032540,796939,1,69235601
"GVAP Indicator",gavi,2000,rcv1,70746374,1007421,1,69738953
"GVAP Indicator",gavi,2001,rcv1,71497127,1529235,2,69967892
"GVAP Indicator",gavi,2002,rcv1,72311931,1611761,2,70700170
"GVAP Indicator",gavi,2003,rcv1,73104660,1709763,2,71394897
"GVAP Indicator",gavi,2004,rcv1,73896934,1728624,2,72168310
"GVAP Indicator",gavi,2005,rcv1,74665309,1770793,2,72894516
"GVAP Indicator",gavi,2006,rcv1,75384977,2366897,3,73018080
"GVAP Indicator",gavi,2007,rcv1,76043087,2404630,3,73638457
"GVAP Indicator",gavi,2008,rcv1,76634785,2602364,3,74032421
"GVAP Indicator",gavi,2009,rcv1,77162051,2779778,4,74382273
"GVAP Indicator",gavi,2010,rcv1,77638415,2761196,4,74877219
"GVAP Indicator",gavi,2011,rcv1,78086066,2870006,4,75216060
"GVAP Indicator",gavi,2012,rcv1,78530916,3562263,5,74968653
"GVAP Indicator",gavi,2013,rcv1,78992372,7754968,10,71237404
"GVAP Indicator",gavi,2014,rcv1,79477574,9688687,12,69788887
"GVAP Indicator",gavi,2015,rcv1,79985890,13478888,17,66507002
"GVAP Indicator",gavi,2016,rcv1,80508460,14042431,17,66466029
"GVAP Indicator",gavi,2017,rcv1,81028147,20071636,25,60956511
"GVAP Indicator",gavi,2006,rotac,75384977,0,0,75384977
"GVAP Indicator",gavi,2007,rotac,76043087,83512,0,75959575
"GVAP Indicator",gavi,2008,rotac,76634785,235452,0,76399333
"GVAP Indicator",gavi,2009,rotac,77162051,461674,1,76700377
"GVAP Indicator",gavi,2010,rotac,77638415,527903,1,77110512
"GVAP Indicator",gavi,2011,rotac,78086066,857833,1,77228233
"GVAP Indicator",gavi,2012,rotac,78530916,2234880,3,76296036
"GVAP Indicator",gavi,2013,rotac,78992372,5237378,7,73754994
"GVAP Indicator",gavi,2014,rotac,79477574,11279067,14,68198507
"GVAP Indicator",gavi,2015,rotac,79985890,15781352,20,64204538
"GVAP Indicator",gavi,2016,rotac,80508460,18716311,23,61792149
"GVAP Indicator",gavi,2017,rotac,81028147,22640453,28,58387694
"GVAP Indicator",gavi,1997,yfv,20041933,771185,4,19270748
"GVAP Indicator",gavi,1998,yfv,20568471,1110739,5,19457732
"GVAP Indicator",gavi,1999,yfv,21101286,1335229,6,19766057
"GVAP Indicator",gavi,2000,yfv,21639554,1624336,8,20015218
"GVAP Indicator",gavi,2001,yfv,22183977,1804218,8,20379759
"GVAP Indicator",gavi,2002,yfv,22735965,2309327,10,20426638
"GVAP Indicator",gavi,2003,yfv,23295720,2892069,12,20403651
"GVAP Indicator",gavi,2004,yfv,23861716,5408886,23,18452830
"GVAP Indicator",gavi,2005,yfv,24432527,7234490,30,17198037
"GVAP Indicator",gavi,2006,yfv,25006768,8083641,32,16923127
"GVAP Indicator",gavi,2007,yfv,25582437,9389257,37,16193180
"GVAP Indicator",gavi,2008,yfv,26157089,9273223,35,16883866
"GVAP Indicator",gavi,2009,yfv,26728281,10770470,40,15957811
"GVAP Indicator",gavi,2010,yfv,27292877,10148652,37,17144225
"GVAP Indicator",gavi,2011,yfv,27848123,9222555,33,18625568
"GVAP Indicator",gavi,2012,yfv,28393596,9277148,33,19116448
"GVAP Indicator",gavi,2013,yfv,28929805,10580606,37,18349199
"GVAP Indicator",gavi,2014,yfv,27489803,10554252,38,16935551
"GVAP Indicator",gavi,2015,yfv,27971313,10743564,38,17227749
"GVAP Indicator",gavi,2016,yfv,27512718,10614697,39,16898021
"GVAP Indicator",gavi,2017,yfv,27971724,11217518,40,16754206
"GVAP Indicator",hic,1980,bcg,7150894,2741364,38,4409530
"GVAP Indicator",hic,1981,bcg,7092275,4690901,66,2401374
"GVAP Indicator",hic,1982,bcg,7031573,4912291,70,2119282
"GVAP Indicator",hic,1983,bcg,6871713,4823082,70,2048631
"GVAP Indicator",hic,1984,bcg,6799728,4987343,73,1812385
"GVAP Indicator",hic,1985,bcg,6671768,4956836,74,1714932
"GVAP Indicator",hic,1986,bcg,6599949,4992824,76,1607125
"GVAP Indicator",hic,1987,bcg,6535567,4937623,76,1597944
"GVAP Indicator",hic,1988,bcg,6481226,4924752,76,1556474
"GVAP Indicator",hic,1989,bcg,6436656,4994644,78,1442012
"GVAP Indicator",hic,1990,bcg,6309626,4921687,78,1387939
"GVAP Indicator",hic,1991,bcg,6272070,5038662,80,1233408
"GVAP Indicator",hic,1992,bcg,6401640,5197534,81,1204106
"GVAP Indicator",hic,1993,bcg,6531907,5307292,81,1224615
"GVAP Indicator",hic,1994,bcg,5241159,4243049,81,998110
"GVAP Indicator",hic,1995,bcg,4524377,4168166,92,356211
"GVAP Indicator",hic,1996,bcg,4454300,4071227,91,383073
"GVAP Indicator",hic,1997,bcg,4379978,3974840,91,405138
"GVAP Indicator",hic,1998,bcg,4316976,3810214,88,506762
"GVAP Indicator",hic,1999,bcg,4263811,3766990,88,496821
"GVAP Indicator",hic,2000,bcg,4224483,3724120,88,500363
"GVAP Indicator",hic,2001,bcg,4201840,3743353,89,458487
"GVAP Indicator",hic,2002,bcg,4194595,3827299,91,367296
"GVAP Indicator",hic,2003,bcg,4200339,3811687,91,388652
"GVAP Indicator",hic,2004,bcg,4216929,3838301,91,378628
"GVAP Indicator",hic,2005,bcg,4221901,3841240,91,380661
"GVAP Indicator",hic,2006,bcg,4299885,3940574,92,359311
"GVAP Indicator",hic,2007,bcg,5382878,4914042,91,468836
"GVAP Indicator",hic,2008,bcg,4614214,4290160,93,324054
"GVAP Indicator",hic,2009,bcg,4624254,4334563,94,289691
"GVAP Indicator",hic,2010,bcg,4513549,4276351,95,237198
"GVAP Indicator",hic,2011,bcg,4508967,4230936,94,278031
"GVAP Indicator",hic,2012,bcg,4499801,4234063,94,265738
"GVAP Indicator",hic,2013,bcg,4487721,4185258,93,302463
"GVAP Indicator",hic,2014,bcg,4472969,4155675,93,317294
"GVAP Indicator",hic,2015,bcg,4455440,3961274,89,494166
"GVAP Indicator",hic,2016,bcg,4354169,4006776,92,347393
"GVAP Indicator",hic,2017,bcg,4332512,3935064,91,397448
"GVAP Indicator",hic,1980,dtp1,13617781,8979124,66,4638657
"GVAP Indicator",hic,1981,dtp1,13631199,10797677,79,2833522
"GVAP Indicator",hic,1982,dtp1,13651054,11034610,81,2616444
"GVAP Indicator",hic,1983,dtp1,13667889,11241081,82,2426808
"GVAP Indicator",hic,1984,dtp1,13677216,11887782,87,1789434
"GVAP Indicator",hic,1985,dtp1,13678389,11889405,87,1788984
"GVAP Indicator",hic,1986,dtp1,13674257,12073249,88,1601008
"GVAP Indicator",hic,1987,dtp1,13669398,12395256,91,1274142
"GVAP Indicator",hic,1988,dtp1,13665821,12420756,91,1245065
"GVAP Indicator",hic,1989,dtp1,13661417,12552098,92,1109319
"GVAP Indicator",hic,1990,dtp1,13649956,13021183,95,628773
"GVAP Indicator",hic,1991,dtp1,13623572,13025108,96,598464
"GVAP Indicator",hic,1992,dtp1,13746454,13090940,95,655514
"GVAP Indicator",hic,1993,dtp1,13857588,13151780,95,705808
"GVAP Indicator",hic,1994,dtp1,13758265,13234593,96,523672
"GVAP Indicator",hic,1995,dtp1,13647109,13169612,97,477497
"GVAP Indicator",hic,1996,dtp1,13532049,13151294,97,380755
"GVAP Indicator",hic,1997,dtp1,13424072,12897895,96,526177
"GVAP Indicator",hic,1998,dtp1,13331586,12808762,96,522824
"GVAP Indicator",hic,1999,dtp1,13261824,12846042,97,415782
"GVAP Indicator",hic,2000,dtp1,13223627,12794318,97,429309
"GVAP Indicator",hic,2001,dtp1,13223949,12919557,98,304392
"GVAP Indicator",hic,2002,dtp1,13259404,12860953,97,398451
"GVAP Indicator",hic,2003,dtp1,13322791,13005581,98,317210
"GVAP Indicator",hic,2004,dtp1,13406389,13102843,98,303546
"GVAP Indicator",hic,2005,dtp1,13495886,13197379,98,298507
"GVAP Indicator",hic,2006,dtp1,13574473,13246495,98,327978
"GVAP Indicator",hic,2007,dtp1,13629847,13311749,98,318098
"GVAP Indicator",hic,2008,dtp1,13654746,13347216,98,307530
"GVAP Indicator",hic,2009,dtp1,13647730,13285274,97,362456
"GVAP Indicator",hic,2010,dtp1,13614465,13268327,97,346138
"GVAP Indicator",hic,2011,dtp1,13566615,13231400,98,335215
"GVAP Indicator",hic,2012,dtp1,13519829,13141625,97,378204
"GVAP Indicator",hic,2013,dtp1,13485928,13127206,97,358722
"GVAP Indicator",hic,2014,dtp1,13468981,13161727,98,307254
"GVAP Indicator",hic,2015,dtp1,13469329,13128482,97,340847
"GVAP Indicator",hic,2016,dtp1,13483043,13182396,98,300647
"GVAP Indicator",hic,2017,dtp1,13501119,13166001,98,335118
"GVAP Indicator",hic,1980,dtp3,13617781,7755746,57,5862035
"GVAP Indicator",hic,1981,dtp3,13631199,9535710,70,4095489
"GVAP Indicator",hic,1982,dtp3,13651054,9891886,72,3759168
"GVAP Indicator",hic,1983,dtp3,13667889,10151113,74,3516776
"GVAP Indicator",hic,1984,dtp3,13677216,10902090,80,2775126
"GVAP Indicator",hic,1985,dtp3,13678389,10779892,79,2898497
"GVAP Indicator",hic,1986,dtp3,13674257,11162379,82,2511878
"GVAP Indicator",hic,1987,dtp3,13669398,11349655,83,2319743
"GVAP Indicator",hic,1988,dtp3,13665821,11440281,84,2225540
"GVAP Indicator",hic,1989,dtp3,13661417,11746119,86,1915298
"GVAP Indicator",hic,1990,dtp3,13649956,12045418,88,1604538
"GVAP Indicator",hic,1991,dtp3,13623572,12001086,88,1622486
"GVAP Indicator",hic,1992,dtp3,13746454,12010644,87,1735810
"GVAP Indicator",hic,1993,dtp3,13857588,12132219,88,1725369
"GVAP Indicator",hic,1994,dtp3,13758265,12476302,91,1281963
"GVAP Indicator",hic,1995,dtp3,13647109,12445508,91,1201601
"GVAP Indicator",hic,1996,dtp3,13532049,12610146,93,921903
"GVAP Indicator",hic,1997,dtp3,13424072,12155224,91,1268848
"GVAP Indicator",hic,1998,dtp3,13331586,12101028,91,1230558
"GVAP Indicator",hic,1999,dtp3,13261824,12288459,93,973365
"GVAP Indicator",hic,2000,dtp3,13223627,12198328,92,1025299
"GVAP Indicator",hic,2001,dtp3,13223949,12411505,94,812444
"GVAP Indicator",hic,2002,dtp3,13259404,12526018,94,733386
"GVAP Indicator",hic,2003,dtp3,13322791,12759314,96,563477
"GVAP Indicator",hic,2004,dtp3,13406389,12820821,96,585568
"GVAP Indicator",hic,2005,dtp3,13495886,12923193,96,572693
"GVAP Indicator",hic,2006,dtp3,13574473,13004744,96,569729
"GVAP Indicator",hic,2007,dtp3,13629847,13022154,96,607693
"GVAP Indicator",hic,2008,dtp3,13654746,13077459,96,577287
"GVAP Indicator",hic,2009,dtp3,13647730,13020227,95,627503
"GVAP Indicator",hic,2010,dtp3,13614465,12998224,95,616241
"GVAP Indicator",hic,2011,dtp3,13566615,12995589,96,571026
"GVAP Indicator",hic,2012,dtp3,13519829,12900788,95,619041
"GVAP Indicator",hic,2013,dtp3,13485928,12856859,95,629069
"GVAP Indicator",hic,2014,dtp3,13468981,12872247,96,596734
"GVAP Indicator",hic,2015,dtp3,13469329,12847895,95,621434
"GVAP Indicator",hic,2016,dtp3,13483043,12866802,95,616241
"GVAP Indicator",hic,2017,dtp3,13501119,12842106,95,659013
"GVAP Indicator",hic,1985,hepb3,13678389,0,0,13678389
"GVAP Indicator",hic,1986,hepb3,13674257,0,0,13674257
"GVAP Indicator",hic,1987,hepb3,13669398,0,0,13669398
"GVAP Indicator",hic,1988,hepb3,13665821,0,0,13665821
"GVAP Indicator",hic,1989,hepb3,13661417,0,0,13661417
"GVAP Indicator",hic,1990,hepb3,13649956,417386,3,13232570
"GVAP Indicator",hic,1991,hepb3,13623572,1149038,8,12474534
"GVAP Indicator",hic,1992,hepb3,13746454,1330423,10,12416031
"GVAP Indicator",hic,1993,hepb3,13857588,2165543,16,11692045
"GVAP Indicator",hic,1994,hepb3,13758265,3345711,24,10412554
"GVAP Indicator",hic,1995,hepb3,13647109,5238896,38,8408213
"GVAP Indicator",hic,1996,hepb3,13532049,6292397,46,7239652
"GVAP Indicator",hic,1997,hepb3,13424072,6645777,50,6778295
"GVAP Indicator",hic,1998,hepb3,13331586,7075333,53,6256253
"GVAP Indicator",hic,1999,hepb3,13261824,7196265,54,6065559
"GVAP Indicator",hic,2000,hepb3,13223627,7402370,56,5821257
"GVAP Indicator",hic,2001,hepb3,13223949,7731706,58,5492243
"GVAP Indicator",hic,2002,hepb3,13259404,8376367,63,4883037
"GVAP Indicator",hic,2003,hepb3,13322791,8714672,65,4608119
"GVAP Indicator",hic,2004,hepb3,13406389,8984657,67,4421732
"GVAP Indicator",hic,2005,hepb3,13495886,9206209,68,4289677
"GVAP Indicator",hic,2006,hepb3,13574473,9489191,70,4085282
"GVAP Indicator",hic,2007,hepb3,13629847,9543530,70,4086317
"GVAP Indicator",hic,2008,hepb3,13654746,9765878,72,3888868
"GVAP Indicator",hic,2009,hepb3,13647730,9780524,72,3867206
"GVAP Indicator",hic,2010,hepb3,13614465,9936140,73,3678325
"GVAP Indicator",hic,2011,hepb3,13566615,10104781,74,3461834
"GVAP Indicator",hic,2012,hepb3,13519829,10054004,74,3465825
"GVAP Indicator",hic,2013,hepb3,13485928,10127248,75,3358680
"GVAP Indicator",hic,2014,hepb3,13468981,10258999,76,3209982
"GVAP Indicator",hic,2015,hepb3,13469329,10292853,76,3176476
"GVAP Indicator",hic,2016,hepb3,13483043,10379238,77,3103805
"GVAP Indicator",hic,2017,hepb3,13501119,10362568,77,3138551
"GVAP Indicator",hic,2000,hepbb,13320613,773965,6,12546648
"GVAP Indicator",hic,2001,hepbb,13317542,1310584,10,12006958
"GVAP Indicator",hic,2002,hepbb,13350337,2225937,17,11124400
"GVAP Indicator",hic,2003,hepbb,13411661,2991121,22,10420540
"GVAP Indicator",hic,2004,hepbb,13493673,3900191,29,9593482
"GVAP Indicator",hic,2005,hepbb,13581893,4062764,30,9519129
"GVAP Indicator",hic,2006,hepbb,13659328,4104332,30,9554996
"GVAP Indicator",hic,2007,hepbb,13713536,4297023,31,9416513
"GVAP Indicator",hic,2008,hepbb,13737116,4421996,32,9315120
"GVAP Indicator",hic,2009,hepbb,13728549,4681415,34,9047134
"GVAP Indicator",hic,2010,hepbb,13693460,4766482,35,8926978
"GVAP Indicator",hic,2011,hepbb,13643540,5043174,37,8600366
"GVAP Indicator",hic,2012,hepbb,13594539,5169101,38,8425438
"GVAP Indicator",hic,2013,hepbb,13558385,5217057,38,8341328
"GVAP Indicator",hic,2014,hepbb,13539201,5559197,41,7980004
"GVAP Indicator",hic,2015,hepbb,13537351,5559097,41,7978254
"GVAP Indicator",hic,2016,hepbb,13548945,5219789,39,8329156
"GVAP Indicator",hic,2017,hepbb,13565072,5430730,40,8134342
"GVAP Indicator",hic,1990,hib3,13649956,0,0,13649956
"GVAP Indicator",hic,1991,hib3,13623572,556332,4,13067240
"GVAP Indicator",hic,1992,hib3,13746454,764169,6,12982285
"GVAP Indicator",hic,1993,hib3,13857588,1564998,11,12292590
"GVAP Indicator",hic,1994,hib3,13758265,1697519,12,12060746
"GVAP Indicator",hic,1995,hib3,13647109,5310217,39,8336892
"GVAP Indicator",hic,1996,hib3,13532049,5942410,44,7589639
"GVAP Indicator",hic,1997,hib3,13424072,6541363,49,6882709
"GVAP Indicator",hic,1998,hib3,13331586,8037641,60,5293945
"GVAP Indicator",hic,1999,hib3,13261824,8722398,66,4539426
"GVAP Indicator",hic,2000,hib3,13223627,9054852,68,4168775
"GVAP Indicator",hic,2001,hib3,13223949,9325268,71,3898681
"GVAP Indicator",hic,2002,hib3,13259404,10260328,77,2999076
"GVAP Indicator",hic,2003,hib3,13322791,10476323,79,2846468
"GVAP Indicator",hic,2004,hib3,13406389,10712259,80,2694130
"GVAP Indicator",hic,2005,hib3,13495886,10893324,81,2602562
"GVAP Indicator",hic,2006,hib3,13574473,10972126,81,2602347
"GVAP Indicator",hic,2007,hib3,13629847,11243659,82,2386188
"GVAP Indicator",hic,2008,hib3,13654746,11264233,82,2390513
"GVAP Indicator",hic,2009,hib3,13647730,10999752,81,2647978
"GVAP Indicator",hic,2010,hib3,13614465,11211743,82,2402722
"GVAP Indicator",hic,2011,hib3,13566615,11332160,84,2234455
"GVAP Indicator",hic,2012,hib3,13519829,11291899,84,2227930
"GVAP Indicator",hic,2013,hib3,13485928,11305742,84,2180186
"GVAP Indicator",hic,2014,hib3,13468981,11726736,87,1742245
"GVAP Indicator",hic,2015,hib3,13469329,12747181,95,722148
"GVAP Indicator",hic,2016,hib3,13483043,12757241,95,725802
"GVAP Indicator",hic,2017,hib3,13501119,12724222,94,776897
"GVAP Indicator",hic,2015,ipv1,2275430,886670,39,1388760
"GVAP Indicator",hic,2016,ipv1,2268741,1566401,69,702340
"GVAP Indicator",hic,2017,ipv1,2258803,1827364,81,431439
"GVAP Indicator",hic,1980,mcv1,13617781,6665131,49,6952650
"GVAP Indicator",hic,1981,mcv1,13631199,7605283,56,6025916
"GVAP Indicator",hic,1982,mcv1,13651054,7896018,58,5755036
"GVAP Indicator",hic,1983,mcv1,13667889,8748912,64,4918977
"GVAP Indicator",hic,1984,mcv1,13677216,9520957,70,4156259
"GVAP Indicator",hic,1985,mcv1,13678389,9839147,72,3839242
"GVAP Indicator",hic,1986,mcv1,13674257,10383227,76,3291030
"GVAP Indicator",hic,1987,mcv1,13669398,10246663,75,3422735
"GVAP Indicator",hic,1988,mcv1,13665821,11060854,81,2604967
"GVAP Indicator",hic,1989,mcv1,13661417,11354413,83,2307004
"GVAP Indicator",hic,1990,mcv1,13649956,11555193,85,2094763
"GVAP Indicator",hic,1991,mcv1,13623572,11521382,85,2102190
"GVAP Indicator",hic,1992,mcv1,13746454,11387930,83,2358524
"GVAP Indicator",hic,1993,mcv1,13857588,11652695,84,2204893
"GVAP Indicator",hic,1994,mcv1,13758265,12061187,88,1697078
"GVAP Indicator",hic,1995,mcv1,13647109,12157976,89,1489133
"GVAP Indicator",hic,1996,mcv1,13532049,12224814,90,1307235
"GVAP Indicator",hic,1997,mcv1,13424072,12071172,90,1352900
"GVAP Indicator",hic,1998,mcv1,13331586,12003702,90,1327884
"GVAP Indicator",hic,1999,mcv1,13261824,12066352,91,1195472
"GVAP Indicator",hic,2000,mcv1,13223627,12052577,91,1171050
"GVAP Indicator",hic,2001,mcv1,13223949,12093009,91,1130940
"GVAP Indicator",hic,2002,mcv1,13259404,12230764,92,1028640
"GVAP Indicator",hic,2003,mcv1,13322791,12397332,93,925459
"GVAP Indicator",hic,2004,mcv1,13406389,12520704,93,885685
"GVAP Indicator",hic,2005,mcv1,13495886,12557427,93,938459
"GVAP Indicator",hic,2006,mcv1,13574473,12660050,93,914423
"GVAP Indicator",hic,2007,mcv1,13629847,12685959,93,943888
"GVAP Indicator",hic,2008,mcv1,13654746,12739622,93,915124
"GVAP Indicator",hic,2009,mcv1,13647730,12633606,93,1014124
"GVAP Indicator",hic,2010,mcv1,13614465,12715281,93,899184
"GVAP Indicator",hic,2011,mcv1,13566615,12685227,94,881388
"GVAP Indicator",hic,2012,mcv1,13519829,12689545,94,830284
"GVAP Indicator",hic,2013,mcv1,13485928,12652711,94,833217
"GVAP Indicator",hic,2014,mcv1,13468981,12685321,94,783660
"GVAP Indicator",hic,2015,mcv1,13469329,12602394,94,866935
"GVAP Indicator",hic,2016,mcv1,13483043,12620266,94,862777
"GVAP Indicator",hic,2017,mcv1,13501119,12630541,94,870578
"GVAP Indicator",hic,2000,mcv2,13608253,2477619,18,11130634
"GVAP Indicator",hic,2001,mcv2,13606495,3514632,26,10091863
"GVAP Indicator",hic,2002,mcv2,13392691,4607020,34,8785671
"GVAP Indicator",hic,2003,mcv2,13481811,4593700,34,8888111
"GVAP Indicator",hic,2004,mcv2,13427315,5525693,41,7901622
"GVAP Indicator",hic,2005,mcv2,13426206,5536352,41,7889854
"GVAP Indicator",hic,2006,mcv2,13536157,5682020,42,7854137
"GVAP Indicator",hic,2007,mcv2,13662103,5728941,42,7933162
"GVAP Indicator",hic,2008,mcv2,13558330,6590819,49,6967511
"GVAP Indicator",hic,2009,mcv2,13605200,6823466,50,6781734
"GVAP Indicator",hic,2010,mcv2,13653513,7421126,54,6232387
"GVAP Indicator",hic,2011,mcv2,13696296,7460102,54,6236194
"GVAP Indicator",hic,2012,mcv2,13803750,7967973,58,5835777
"GVAP Indicator",hic,2013,mcv2,13746481,8528721,62,5217760
"GVAP Indicator",hic,2014,mcv2,13739861,8740786,64,4999075
"GVAP Indicator",hic,2015,mcv2,13723586,8683089,63,5040497
"GVAP Indicator",hic,2016,mcv2,13593627,12385124,91,1208503
"GVAP Indicator",hic,2017,mcv2,13470602,12295902,91,1174700
"GVAP Indicator",hic,2000,mcv2x2,13458440,1570179,12,11888261
"GVAP Indicator",hic,2001,mcv2x2,13219976,182630,1,13037346
"GVAP Indicator",hic,2002,mcv2x2,13013441,813114,6,12200327
"GVAP Indicator",hic,2003,mcv2x2,13241121,839731,6,12401390
"GVAP Indicator",hic,2004,mcv2x2,13226593,941196,7,12285397
"GVAP Indicator",hic,2005,mcv2x2,13258899,955139,7,12303760
"GVAP Indicator",hic,2006,mcv2x2,13429753,970191,7,12459562
"GVAP Indicator",hic,2007,mcv2x2,13612033,877297,6,12734736
"GVAP Indicator",hic,2008,mcv2x2,13587809,897585,7,12690224
"GVAP Indicator",hic,2009,mcv2x2,13704821,906752,7,12798069
"GVAP Indicator",hic,2010,mcv2x2,13773855,1468252,11,12305603
"GVAP Indicator",hic,2011,mcv2x2,13927091,1538733,11,12388358
"GVAP Indicator",hic,2012,mcv2x2,14042605,1979922,14,12062683
"GVAP Indicator",hic,2013,mcv2x2,13742214,1992559,14,11749655
"GVAP Indicator",hic,2014,mcv2x2,13685156,2998844,22,10686312
"GVAP Indicator",hic,2015,mcv2x2,13635421,3021673,22,10613748
"GVAP Indicator",hic,2016,mcv2x2,13419078,6809896,51,6609182
"GVAP Indicator",hic,2017,mcv2x2,13232163,6735914,51,6496249
"GVAP Indicator",hic,2008,pcv3,13654746,5197537,38,8457209
"GVAP Indicator",hic,2009,pcv3,13647730,6435937,47,7211793
"GVAP Indicator",hic,2010,pcv3,13614465,8141976,60,5472489
"GVAP Indicator",hic,2011,pcv3,13566615,9715950,72,3850665
"GVAP Indicator",hic,2012,pcv3,13519829,10252045,76,3267784
"GVAP Indicator",hic,2013,pcv3,13485928,10668113,79,2817815
"GVAP Indicator",hic,2014,pcv3,13468981,10840183,80,2628798
"GVAP Indicator",hic,2015,pcv3,13469329,11275805,84,2193524
"GVAP Indicator",hic,2016,pcv3,13483043,11444738,85,2038305
"GVAP Indicator",hic,2017,pcv3,13501119,11472519,85,2028600
"GVAP Indicator",hic,1980,pol3,13617781,7522759,55,6095022
"GVAP Indicator",hic,1981,pol3,13631199,8466034,62,5165165
"GVAP Indicator",hic,1982,pol3,13651054,10320575,76,3330479
"GVAP Indicator",hic,1983,pol3,13667889,11386752,83,2281137
"GVAP Indicator",hic,1984,pol3,13677216,11913069,87,1764147
"GVAP Indicator",hic,1985,pol3,13678389,11914984,87,1763405
"GVAP Indicator",hic,1986,pol3,13674257,12163913,89,1510344
"GVAP Indicator",hic,1987,pol3,13669398,12476362,91,1193036
"GVAP Indicator",hic,1988,pol3,13665821,12503286,91,1162535
"GVAP Indicator",hic,1989,pol3,13661417,12248725,90,1412692
"GVAP Indicator",hic,1990,pol3,13649956,12065967,88,1583989
"GVAP Indicator",hic,1991,pol3,13623572,11770063,86,1853509
"GVAP Indicator",hic,1992,pol3,13746454,11680390,85,2066064
"GVAP Indicator",hic,1993,pol3,13857588,12140281,88,1717307
"GVAP Indicator",hic,1994,pol3,13758265,12470064,91,1288201
"GVAP Indicator",hic,1995,pol3,13647109,12668180,93,978929
"GVAP Indicator",hic,1996,pol3,13532049,12648061,93,883988
"GVAP Indicator",hic,1997,pol3,13424072,12432795,93,991277
"GVAP Indicator",hic,1998,pol3,13331586,12250818,92,1080768
"GVAP Indicator",hic,1999,pol3,13261824,12291578,93,970246
"GVAP Indicator",hic,2000,pol3,13223627,12314896,93,908731
"GVAP Indicator",hic,2001,pol3,13223949,12101878,92,1122071
"GVAP Indicator",hic,2002,pol3,13259404,12338122,93,921282
"GVAP Indicator",hic,2003,pol3,13322791,12506392,94,816399
"GVAP Indicator",hic,2004,pol3,13406389,12616457,94,789932
"GVAP Indicator",hic,2005,pol3,13495886,12709175,94,786711
"GVAP Indicator",hic,2006,pol3,13574473,12854724,95,719749
"GVAP Indicator",hic,2007,pol3,13629847,12870686,94,759161
"GVAP Indicator",hic,2008,pol3,13654746,12964515,95,690231
"GVAP Indicator",hic,2009,pol3,13647730,12961398,95,686332
"GVAP Indicator",hic,2010,pol3,13614465,12919325,95,695140
"GVAP Indicator",hic,2011,pol3,13566615,12897172,95,669443
"GVAP Indicator",hic,2012,pol3,13519829,12865343,95,654486
"GVAP Indicator",hic,2013,pol3,13485928,12798749,95,687179
"GVAP Indicator",hic,2014,pol3,13468981,12792537,95,676444
"GVAP Indicator",hic,2015,pol3,13469329,12754801,95,714528
"GVAP Indicator",hic,2016,pol3,13483043,12751820,95,731223
"GVAP Indicator",hic,2017,pol3,13501119,12712948,94,788171
"GVAP Indicator",hic,1980,rcv1,13617781,3484718,26,10133063
"GVAP Indicator",hic,1981,rcv1,13631199,4049680,30,9581519
"GVAP Indicator",hic,1982,rcv1,13651054,4398397,32,9252657
"GVAP Indicator",hic,1983,rcv1,13667889,5124800,37,8543089
"GVAP Indicator",hic,1984,rcv1,13677216,5706801,42,7970415
"GVAP Indicator",hic,1985,rcv1,13678389,6264660,46,7413729
"GVAP Indicator",hic,1986,rcv1,13674257,6473050,47,7201207
"GVAP Indicator",hic,1987,rcv1,13669398,6276109,46,7393289
"GVAP Indicator",hic,1988,rcv1,13665821,7590205,56,6075616
"GVAP Indicator",hic,1989,rcv1,13661417,8964614,66,4696803
"GVAP Indicator",hic,1990,rcv1,13649956,9464646,69,4185310
"GVAP Indicator",hic,1991,rcv1,13623572,10496532,77,3127040
"GVAP Indicator",hic,1992,rcv1,13746454,10437273,76,3309181
"GVAP Indicator",hic,1993,rcv1,13857588,10707457,77,3150131
"GVAP Indicator",hic,1994,rcv1,13758265,11169092,81,2589173
"GVAP Indicator",hic,1995,rcv1,13647109,11465214,84,2181895
"GVAP Indicator",hic,1996,rcv1,13532049,11532959,85,1999090
"GVAP Indicator",hic,1997,rcv1,13424072,12070890,90,1353182
"GVAP Indicator",hic,1998,rcv1,13331586,12003451,90,1328135
"GVAP Indicator",hic,1999,rcv1,13261824,12066218,91,1195606
"GVAP Indicator",hic,2000,rcv1,13223627,12052556,91,1171071
"GVAP Indicator",hic,2001,rcv1,13223949,12092760,91,1131189
"GVAP Indicator",hic,2002,rcv1,13259404,12230661,92,1028743
"GVAP Indicator",hic,2003,rcv1,13322791,12397198,93,925593
"GVAP Indicator",hic,2004,rcv1,13406389,12520539,93,885850
"GVAP Indicator",hic,2005,rcv1,13495886,12557234,93,938652
"GVAP Indicator",hic,2006,rcv1,13574473,12660045,93,914428
"GVAP Indicator",hic,2007,rcv1,13629847,12685959,93,943888
"GVAP Indicator",hic,2008,rcv1,13654746,12739622,93,915124
"GVAP Indicator",hic,2009,rcv1,13647730,12633591,93,1014139
"GVAP Indicator",hic,2010,rcv1,13614465,12715281,93,899184
"GVAP Indicator",hic,2011,rcv1,13566615,12685227,94,881388
"GVAP Indicator",hic,2012,rcv1,13519829,12689545,94,830284
"GVAP Indicator",hic,2013,rcv1,13485928,12652711,94,833217
"GVAP Indicator",hic,2014,rcv1,13468981,12685321,94,783660
"GVAP Indicator",hic,2015,rcv1,13469329,12602394,94,866935
"GVAP Indicator",hic,2016,rcv1,13483043,12620266,94,862777
"GVAP Indicator",hic,2017,rcv1,13501119,12630541,94,870578
"GVAP Indicator",hic,2006,rotac,13574473,59703,0,13514770
"GVAP Indicator",hic,2007,rotac,13629847,48537,0,13581310
"GVAP Indicator",hic,2008,rotac,13654746,335541,2,13319205
"GVAP Indicator",hic,2009,rotac,13647730,2164912,16,11482818
"GVAP Indicator",hic,2010,rotac,13614465,2818775,21,10795690
"GVAP Indicator",hic,2011,rotac,13566615,3144227,23,10422388
"GVAP Indicator",hic,2012,rotac,13519829,3448201,26,10071628
"GVAP Indicator",hic,2013,rotac,13485928,4112612,30,9373316
"GVAP Indicator",hic,2014,rotac,13468981,4693597,35,8775384
"GVAP Indicator",hic,2015,rotac,13469329,5954388,44,7514941
"GVAP Indicator",hic,2016,rotac,13483043,6203247,46,7279796
"GVAP Indicator",hic,2017,rotac,13501119,6355079,47,7146040
"GVAP Indicator",hic,1997,yfv,86468,0,0,86468
"GVAP Indicator",hic,1998,yfv,86825,16707,19,70118
"GVAP Indicator",hic,1999,yfv,87237,16566,19,70671
"GVAP Indicator",hic,2000,yfv,87706,16537,19,71169
"GVAP Indicator",hic,2001,yfv,88250,16611,19,71639
"GVAP Indicator",hic,2002,yfv,88881,16210,18,72671
"GVAP Indicator",hic,2003,yfv,89600,16401,18,73199
"GVAP Indicator",hic,2004,yfv,90390,16990,19,73400
"GVAP Indicator",hic,2005,yfv,91237,17774,19,73463
"GVAP Indicator",hic,2006,yfv,92130,17003,18,75127
"GVAP Indicator",hic,2007,yfv,93038,17547,19,75491
"GVAP Indicator",hic,2008,yfv,93922,16878,18,77044
"GVAP Indicator",hic,2009,yfv,830647,77383,9,753264
"GVAP Indicator",hic,2010,yfv,833805,122069,15,711736
"GVAP Indicator",hic,2011,yfv,836576,107478,13,729098
"GVAP Indicator",hic,2012,yfv,838705,79731,10,758974
"GVAP Indicator",hic,2013,yfv,840013,72194,9,767819
"GVAP Indicator",hic,2014,yfv,840467,74062,9,766405
"GVAP Indicator",hic,2015,yfv,840100,57915,7,782185
"GVAP Indicator",hic,2016,yfv,839031,64650,8,774381
"GVAP Indicator",hic,2017,yfv,837502,66005,8,771497
"GVAP Indicator",mic_nongavi,1980,bcg,43323083,9081958,21,34241125
"GVAP Indicator",mic_nongavi,1981,bcg,43993933,10166441,23,33827492
"GVAP Indicator",mic_nongavi,1982,bcg,45002929,11601705,26,33401224
"GVAP Indicator",mic_nongavi,1983,bcg,46231907,21137514,46,25094393
"GVAP Indicator",mic_nongavi,1984,bcg,47557632,28203941,59,19353691
"GVAP Indicator",mic_nongavi,1985,bcg,48782322,32060508,66,16721814
"GVAP Indicator",mic_nongavi,1986,bcg,49690909,35205185,71,14485724
"GVAP Indicator",mic_nongavi,1987,bcg,50151317,40521733,81,9629584
"GVAP Indicator",mic_nongavi,1988,bcg,50083320,45514084,91,4569236
"GVAP Indicator",mic_nongavi,1989,bcg,49477660,45296418,92,4181242
"GVAP Indicator",mic_nongavi,1990,bcg,48385811,44850482,93,3535329
"GVAP Indicator",mic_nongavi,1991,bcg,46981740,43777599,93,3204141
"GVAP Indicator",mic_nongavi,1992,bcg,47879959,44112187,92,3767772
"GVAP Indicator",mic_nongavi,1993,bcg,46261491,42713977,92,3547514
"GVAP Indicator",mic_nongavi,1994,bcg,44657597,40923702,92,3733895
"GVAP Indicator",mic_nongavi,1995,bcg,43297534,37890543,88,5406991
"GVAP Indicator",mic_nongavi,1996,bcg,42219854,38042640,90,4177214
"GVAP Indicator",mic_nongavi,1997,bcg,41377445,37294633,90,4082812
"GVAP Indicator",mic_nongavi,1998,bcg,40727382,36701190,90,4026192
"GVAP Indicator",mic_nongavi,1999,bcg,40267040,36589496,91,3677544
"GVAP Indicator",mic_nongavi,2000,bcg,39984771,36451436,91,3533335
"GVAP Indicator",mic_nongavi,2001,bcg,39859016,36209434,91,3649582
"GVAP Indicator",mic_nongavi,2002,bcg,40015344,36110491,90,3904853
"GVAP Indicator",mic_nongavi,2003,bcg,40096459,36371017,91,3725442
"GVAP Indicator",mic_nongavi,2004,bcg,40239300,36621304,91,3617996
"GVAP Indicator",mic_nongavi,2005,bcg,40440033,36839174,91,3600859
"GVAP Indicator",mic_nongavi,2006,bcg,40708623,38157123,94,2551500
"GVAP Indicator",mic_nongavi,2007,bcg,41047939,38811508,95,2236431
"GVAP Indicator",mic_nongavi,2008,bcg,41443164,39871105,96,1572059
"GVAP Indicator",mic_nongavi,2009,bcg,41860954,40503915,97,1357039
"GVAP Indicator",mic_nongavi,2010,bcg,42252864,40626976,96,1625888
"GVAP Indicator",mic_nongavi,2011,bcg,42567705,41109716,97,1457989
"GVAP Indicator",mic_nongavi,2012,bcg,42770113,41318589,97,1451524
"GVAP Indicator",mic_nongavi,2013,bcg,42836285,41164306,96,1671979
"GVAP Indicator",mic_nongavi,2014,bcg,42754870,41003428,96,1751442
"GVAP Indicator",mic_nongavi,2015,bcg,42526208,40624617,96,1901591
"GVAP Indicator",mic_nongavi,2016,bcg,42166697,40047927,95,2118770
"GVAP Indicator",mic_nongavi,2017,bcg,41719025,39251658,94,2467367
"GVAP Indicator",mic_nongavi,1980,dtp1,40870276,11452589,28,29417687
"GVAP Indicator",mic_nongavi,1981,dtp1,41611591,12431042,30,29180549
"GVAP Indicator",mic_nongavi,1982,dtp1,42670422,13478967,32,29191455
"GVAP Indicator",mic_nongavi,1983,dtp1,43935120,32682865,74,11252255
"GVAP Indicator",mic_nongavi,1984,dtp1,45288558,37126263,82,8162295
"GVAP Indicator",mic_nongavi,1985,dtp1,46541409,40308707,87,6232702
"GVAP Indicator",mic_nongavi,1986,dtp1,47487562,41453987,87,6033575
"GVAP Indicator",mic_nongavi,1987,dtp1,47998874,42444863,88,5554011
"GVAP Indicator",mic_nongavi,1988,dtp1,47998865,44898028,94,3100837
"GVAP Indicator",mic_nongavi,1989,dtp1,47479353,44575525,94,2903828
"GVAP Indicator",mic_nongavi,1990,dtp1,46490718,43988870,95,2501848
"GVAP Indicator",mic_nongavi,1991,dtp1,45199683,42925575,95,2274108
"GVAP Indicator",mic_nongavi,1992,dtp1,46149132,43572914,94,2576218
"GVAP Indicator",mic_nongavi,1993,dtp1,44652315,41948765,94,2703550
"GVAP Indicator",mic_nongavi,1994,dtp1,43168931,39001316,90,4167615
"GVAP Indicator",mic_nongavi,1995,dtp1,41920208,38530811,92,3389397
"GVAP Indicator",mic_nongavi,1996,dtp1,40942732,37611474,92,3331258
"GVAP Indicator",mic_nongavi,1997,dtp1,40190527,38087520,95,2103007
"GVAP Indicator",mic_nongavi,1998,dtp1,39621921,37544903,95,2077018
"GVAP Indicator",mic_nongavi,1999,dtp1,39234494,37298316,95,1936178
"GVAP Indicator",mic_nongavi,2000,dtp1,39017407,37060232,95,1957175
"GVAP Indicator",mic_nongavi,2001,dtp1,38950462,36928282,95,2022180
"GVAP Indicator",mic_nongavi,2002,dtp1,38998918,36721639,94,2277279
"GVAP Indicator",mic_nongavi,2003,dtp1,39129286,36786631,94,2342655
"GVAP Indicator",mic_nongavi,2004,dtp1,39318941,37244498,95,2074443
"GVAP Indicator",mic_nongavi,2005,dtp1,39564576,37721029,95,1843547
"GVAP Indicator",mic_nongavi,2006,dtp1,39876221,38489604,97,1386617
"GVAP Indicator",mic_nongavi,2007,dtp1,40256332,38775413,96,1480919
"GVAP Indicator",mic_nongavi,2008,dtp1,40689911,39515489,97,1174422
"GVAP Indicator",mic_nongavi,2009,dtp1,41143864,39859402,97,1284462
"GVAP Indicator",mic_nongavi,2010,dtp1,41570059,40023330,96,1546729
"GVAP Indicator",mic_nongavi,2011,dtp1,41917585,40659173,97,1258412
"GVAP Indicator",mic_nongavi,2012,dtp1,42151245,40672135,96,1479110
"GVAP Indicator",mic_nongavi,2013,dtp1,42247377,40748299,96,1499078
"GVAP Indicator",mic_nongavi,2014,dtp1,42194729,40286884,95,1907845
"GVAP Indicator",mic_nongavi,2015,dtp1,41993649,39941305,95,2052344
"GVAP Indicator",mic_nongavi,2016,dtp1,41660425,39931592,96,1728833
"GVAP Indicator",mic_nongavi,2017,dtp1,41237463,39546127,96,1691336
"GVAP Indicator",mic_nongavi,1980,dtp3,40870276,7229011,18,33641265
"GVAP Indicator",mic_nongavi,1981,dtp3,41611591,8223111,20,33388480
"GVAP Indicator",mic_nongavi,1982,dtp3,42670422,9079464,21,33590958
"GVAP Indicator",mic_nongavi,1983,dtp3,43935120,23174024,53,20761096
"GVAP Indicator",mic_nongavi,1984,dtp3,45288558,28799172,64,16489386
"GVAP Indicator",mic_nongavi,1985,dtp3,46541409,32525470,70,14015939
"GVAP Indicator",mic_nongavi,1986,dtp3,47487562,33498093,71,13989469
"GVAP Indicator",mic_nongavi,1987,dtp3,47998874,34502957,72,13495917
"GVAP Indicator",mic_nongavi,1988,dtp3,47998865,40848393,85,7150472
"GVAP Indicator",mic_nongavi,1989,dtp3,47479353,40578217,85,6901136
"GVAP Indicator",mic_nongavi,1990,dtp3,46490718,40903089,88,5587629
"GVAP Indicator",mic_nongavi,1991,dtp3,45199683,39772080,88,5427603
"GVAP Indicator",mic_nongavi,1992,dtp3,46149132,39542418,86,6606714
"GVAP Indicator",mic_nongavi,1993,dtp3,44652315,37728064,84,6924251
"GVAP Indicator",mic_nongavi,1994,dtp3,43168931,36229972,84,6938959
"GVAP Indicator",mic_nongavi,1995,dtp3,41920208,34345003,82,7575205
"GVAP Indicator",mic_nongavi,1996,dtp3,40942732,34277946,84,6664786
"GVAP Indicator",mic_nongavi,1997,dtp3,40190527,34203495,85,5987032
"GVAP Indicator",mic_nongavi,1998,dtp3,39621921,34162437,86,5459484
"GVAP Indicator",mic_nongavi,1999,dtp3,39234494,34309264,87,4925230
"GVAP Indicator",mic_nongavi,2000,dtp3,39017407,34468555,88,4548852
"GVAP Indicator",mic_nongavi,2001,dtp3,38950462,34477352,89,4473110
"GVAP Indicator",mic_nongavi,2002,dtp3,38998918,34387348,88,4611570
"GVAP Indicator",mic_nongavi,2003,dtp3,39129286,34555474,88,4573812
"GVAP Indicator",mic_nongavi,2004,dtp3,39318941,35319100,90,3999841
"GVAP Indicator",mic_nongavi,2005,dtp3,39564576,35688776,90,3875800
"GVAP Indicator",mic_nongavi,2006,dtp3,39876221,37006694,93,2869527
"GVAP Indicator",mic_nongavi,2007,dtp3,40256332,37317440,93,2938892
"GVAP Indicator",mic_nongavi,2008,dtp3,40689911,38472071,95,2217840
"GVAP Indicator",mic_nongavi,2009,dtp3,41143864,39361010,96,1782854
"GVAP Indicator",mic_nongavi,2010,dtp3,41570059,39440484,95,2129575
"GVAP Indicator",mic_nongavi,2011,dtp3,41917585,39911608,95,2005977
"GVAP Indicator",mic_nongavi,2012,dtp3,42151245,39982146,95,2169099
"GVAP Indicator",mic_nongavi,2013,dtp3,42247377,39871539,94,2375838
"GVAP Indicator",mic_nongavi,2014,dtp3,42194729,39087381,93,3107348
"GVAP Indicator",mic_nongavi,2015,dtp3,41993649,38751776,92,3241873
"GVAP Indicator",mic_nongavi,2016,dtp3,41660425,38979355,94,2681070
"GVAP Indicator",mic_nongavi,2017,dtp3,41237463,38599063,94,2638400
"GVAP Indicator",mic_nongavi,1985,hepb3,46541409,0,0,46541409
"GVAP Indicator",mic_nongavi,1986,hepb3,47487562,0,0,47487562
"GVAP Indicator",mic_nongavi,1987,hepb3,47998874,0,0,47998874
"GVAP Indicator",mic_nongavi,1988,hepb3,47998865,0,0,47998865
"GVAP Indicator",mic_nongavi,1989,hepb3,47479353,340837,1,47138516
"GVAP Indicator",mic_nongavi,1990,hepb3,46490718,434272,1,46056446
"GVAP Indicator",mic_nongavi,1991,hepb3,45199683,459485,1,44740198
"GVAP Indicator",mic_nongavi,1992,hepb3,46149132,781296,2,45367836
"GVAP Indicator",mic_nongavi,1993,hepb3,44652315,1262145,3,43390170
"GVAP Indicator",mic_nongavi,1994,hepb3,43168931,3742177,9,39426754
"GVAP Indicator",mic_nongavi,1995,hepb3,41920208,6153465,15,35766743
"GVAP Indicator",mic_nongavi,1996,hepb3,40942732,7000731,17,33942001
"GVAP Indicator",mic_nongavi,1997,hepb3,40190527,7829587,19,32360940
"GVAP Indicator",mic_nongavi,1998,hepb3,39621921,7842664,20,31779257
"GVAP Indicator",mic_nongavi,1999,hepb3,39234494,11109680,28,28124814
"GVAP Indicator",mic_nongavi,2000,hepb3,39017407,24328576,62,14688831
"GVAP Indicator",mic_nongavi,2001,hepb3,38950462,26981993,69,11968469
"GVAP Indicator",mic_nongavi,2002,hepb3,38998918,28405419,73,10593499
"GVAP Indicator",mic_nongavi,2003,hepb3,39129286,30564952,78,8564334
"GVAP Indicator",mic_nongavi,2004,hepb3,39318941,32303116,82,7015825
"GVAP Indicator",mic_nongavi,2005,hepb3,39564576,34079002,86,5485574
"GVAP Indicator",mic_nongavi,2006,hepb3,39876221,36130303,91,3745918
"GVAP Indicator",mic_nongavi,2007,hepb3,40256332,36985677,92,3270655
"GVAP Indicator",mic_nongavi,2008,hepb3,40689911,37791146,93,2898765
"GVAP Indicator",mic_nongavi,2009,hepb3,41143864,39134978,95,2008886
"GVAP Indicator",mic_nongavi,2010,hepb3,41570059,39171781,94,2398278
"GVAP Indicator",mic_nongavi,2011,hepb3,41917585,39933336,95,1984249
"GVAP Indicator",mic_nongavi,2012,hepb3,42151245,39927551,95,2223694
"GVAP Indicator",mic_nongavi,2013,hepb3,42247377,39775461,94,2471916
"GVAP Indicator",mic_nongavi,2014,hepb3,42194729,39131503,93,3063226
"GVAP Indicator",mic_nongavi,2015,hepb3,41993649,38629348,92,3364301
"GVAP Indicator",mic_nongavi,2016,hepb3,41660425,38884789,93,2775636
"GVAP Indicator",mic_nongavi,2017,hepb3,41237463,38625121,94,2612342
"GVAP Indicator",mic_nongavi,2000,hepbb,40219294,6027694,15,34191600
"GVAP Indicator",mic_nongavi,2001,hepbb,40093320,6112607,15,33980713
"GVAP Indicator",mic_nongavi,2002,hepbb,40087328,6118818,15,33968510
"GVAP Indicator",mic_nongavi,2003,hepbb,40166465,7474656,19,32691809
"GVAP Indicator",mic_nongavi,2004,hepbb,40307421,21773162,54,18534259
"GVAP Indicator",mic_nongavi,2005,hepbb,40506745,23771225,59,16735520
"GVAP Indicator",mic_nongavi,2006,hepbb,40774830,24307623,60,16467207
"GVAP Indicator",mic_nongavi,2007,hepbb,41114785,24542941,60,16571844
"GVAP Indicator",mic_nongavi,2008,hepbb,41511883,26062380,63,15449503
"GVAP Indicator",mic_nongavi,2009,hepbb,41932729,26478548,63,15454181
"GVAP Indicator",mic_nongavi,2010,hepbb,42328711,28478301,67,13850410
"GVAP Indicator",mic_nongavi,2011,hepbb,42648351,29708851,70,12939500
"GVAP Indicator",mic_nongavi,2012,hepbb,42855820,29606565,69,13249255
"GVAP Indicator",mic_nongavi,2013,hepbb,42926864,30478296,71,12448568
"GVAP Indicator",mic_nongavi,2014,hepbb,42849824,29646666,69,13203158
"GVAP Indicator",mic_nongavi,2015,hepbb,42624778,30343997,71,12280781
"GVAP Indicator",mic_nongavi,2016,hepbb,42267969,29923119,71,12344850
"GVAP Indicator",mic_nongavi,2017,hepbb,41822151,33210692,79,8611459
"GVAP Indicator",mic_nongavi,1990,hib3,46490718,0,0,46490718
"GVAP Indicator",mic_nongavi,1991,hib3,45199683,0,0,45199683
"GVAP Indicator",mic_nongavi,1992,hib3,46149132,0,0,46149132
"GVAP Indicator",mic_nongavi,1993,hib3,44652315,0,0,44652315
"GVAP Indicator",mic_nongavi,1994,hib3,43168931,0,0,43168931
"GVAP Indicator",mic_nongavi,1995,hib3,41920208,0,0,41920208
"GVAP Indicator",mic_nongavi,1996,hib3,40942732,0,0,40942732
"GVAP Indicator",mic_nongavi,1997,hib3,40190527,19605,0,40170922
"GVAP Indicator",mic_nongavi,1998,hib3,39621921,631247,2,38990674
"GVAP Indicator",mic_nongavi,1999,hib3,39234494,775292,2,38459202
"GVAP Indicator",mic_nongavi,2000,hib3,39017407,7072759,18,31944648
"GVAP Indicator",mic_nongavi,2001,hib3,38950462,7310373,19,31640089
"GVAP Indicator",mic_nongavi,2002,hib3,38998918,7728128,20,31270790
"GVAP Indicator",mic_nongavi,2003,hib3,39129286,8463385,22,30665901
"GVAP Indicator",mic_nongavi,2004,hib3,39318941,9316189,24,30002752
"GVAP Indicator",mic_nongavi,2005,hib3,39564576,9960940,25,29603636
"GVAP Indicator",mic_nongavi,2006,hib3,39876221,9848091,25,30028130
"GVAP Indicator",mic_nongavi,2007,hib3,40256332,11552463,29,28703869
"GVAP Indicator",mic_nongavi,2008,hib3,40689911,12775716,31,27914195
"GVAP Indicator",mic_nongavi,2009,hib3,41143864,13214902,32,27928962
"GVAP Indicator",mic_nongavi,2010,hib3,41570059,13410783,32,28159276
"GVAP Indicator",mic_nongavi,2011,hib3,41917585,14049664,34,27867921
"GVAP Indicator",mic_nongavi,2012,hib3,42151245,14878209,35,27273036
"GVAP Indicator",mic_nongavi,2013,hib3,42247377,16582995,39,25664382
"GVAP Indicator",mic_nongavi,2014,hib3,42194729,18323568,43,23871161
"GVAP Indicator",mic_nongavi,2015,hib3,41993649,19444423,46,22549226
"GVAP Indicator",mic_nongavi,2016,hib3,41660425,19927170,48,21733255
"GVAP Indicator",mic_nongavi,2017,hib3,41237463,19978047,48,21259416
"GVAP Indicator",mic_nongavi,2015,ipv1,23361069,12364394,53,10996675
"GVAP Indicator",mic_nongavi,2016,ipv1,23236612,15321151,66,7915461
"GVAP Indicator",mic_nongavi,2017,ipv1,23068272,15973765,69,7094507
"GVAP Indicator",mic_nongavi,1980,mcv1,40870276,5623025,14,35247251
"GVAP Indicator",mic_nongavi,1981,mcv1,41611591,6837914,16,34773677
"GVAP Indicator",mic_nongavi,1982,mcv1,42670422,7580111,18,35090311
"GVAP Indicator",mic_nongavi,1983,mcv1,43935120,26170977,60,17764143
"GVAP Indicator",mic_nongavi,1984,mcv1,45288558,29581722,65,15706836
"GVAP Indicator",mic_nongavi,1985,mcv1,46541409,34722947,75,11818462
"GVAP Indicator",mic_nongavi,1986,mcv1,47487562,29369661,62,18117901
"GVAP Indicator",mic_nongavi,1987,mcv1,47998874,34199399,71,13799475
"GVAP Indicator",mic_nongavi,1988,mcv1,47998865,40483866,84,7514999
"GVAP Indicator",mic_nongavi,1989,mcv1,47479353,40578192,85,6901161
"GVAP Indicator",mic_nongavi,1990,mcv1,46490718,41414332,89,5076386
"GVAP Indicator",mic_nongavi,1991,mcv1,45199683,39257035,87,5942648
"GVAP Indicator",mic_nongavi,1992,mcv1,46149132,39285076,85,6864056
"GVAP Indicator",mic_nongavi,1993,mcv1,44652315,36624038,82,8028277
"GVAP Indicator",mic_nongavi,1994,mcv1,43168931,34318527,79,8850404
"GVAP Indicator",mic_nongavi,1995,mcv1,41920208,34615877,83,7304331
"GVAP Indicator",mic_nongavi,1996,mcv1,40942732,34694403,85,6248329
"GVAP Indicator",mic_nongavi,1997,mcv1,40190527,34732543,86,5457984
"GVAP Indicator",mic_nongavi,1998,mcv1,39621921,34600156,87,5021765
"GVAP Indicator",mic_nongavi,1999,mcv1,39234494,34484622,88,4749872
"GVAP Indicator",mic_nongavi,2000,mcv1,39017407,34474166,88,4543241
"GVAP Indicator",mic_nongavi,2001,mcv1,38950462,34716633,89,4233829
"GVAP Indicator",mic_nongavi,2002,mcv1,38998918,34416980,88,4581938
"GVAP Indicator",mic_nongavi,2003,mcv1,39129286,34536071,88,4593215
"GVAP Indicator",mic_nongavi,2004,mcv1,39318941,34940890,89,4378051
"GVAP Indicator",mic_nongavi,2005,mcv1,39564576,35287165,89,4277411
"GVAP Indicator",mic_nongavi,2006,mcv1,39876221,37028402,93,2847819
"GVAP Indicator",mic_nongavi,2007,mcv1,40256332,37468764,93,2787568
"GVAP Indicator",mic_nongavi,2008,mcv1,40689911,38533848,95,2156063
"GVAP Indicator",mic_nongavi,2009,mcv1,41143864,39285827,95,1858037
"GVAP Indicator",mic_nongavi,2010,mcv1,41570059,39377275,95,2192784
"GVAP Indicator",mic_nongavi,2011,mcv1,41917585,40045123,96,1872462
"GVAP Indicator",mic_nongavi,2012,mcv1,42151245,40134167,95,2017078
"GVAP Indicator",mic_nongavi,2013,mcv1,42247377,39869835,94,2377542
"GVAP Indicator",mic_nongavi,2014,mcv1,42194729,39567128,94,2627601
"GVAP Indicator",mic_nongavi,2015,mcv1,41993649,39531570,94,2462079
"GVAP Indicator",mic_nongavi,2016,mcv1,41660425,39229320,94,2431105
"GVAP Indicator",mic_nongavi,2017,mcv1,41237463,38871112,94,2366351
"GVAP Indicator",mic_nongavi,2000,mcv2,39509587,14068672,36,25440915
"GVAP Indicator",mic_nongavi,2001,mcv2,39588084,15431172,39,24156912
"GVAP Indicator",mic_nongavi,2002,mcv2,39941033,14682146,37,25258887
"GVAP Indicator",mic_nongavi,2003,mcv2,38489818,14739545,38,23750273
"GVAP Indicator",mic_nongavi,2004,mcv2,38719096,15119710,39,23599386
"GVAP Indicator",mic_nongavi,2005,mcv2,38834740,28557220,74,10277520
"GVAP Indicator",mic_nongavi,2006,mcv2,39287481,30243271,77,9044210
"GVAP Indicator",mic_nongavi,2007,mcv2,39742529,30398935,76,9343594
"GVAP Indicator",mic_nongavi,2008,mcv2,39355709,30489038,77,8866671
"GVAP Indicator",mic_nongavi,2009,mcv2,39600946,32271010,81,7329936
"GVAP Indicator",mic_nongavi,2010,mcv2,39950797,32609387,82,7341410
"GVAP Indicator",mic_nongavi,2011,mcv2,40240674,34135270,85,6105404
"GVAP Indicator",mic_nongavi,2012,mcv2,40551773,34199309,84,6352464
"GVAP Indicator",mic_nongavi,2013,mcv2,41305294,34799583,84,6505711
"GVAP Indicator",mic_nongavi,2014,mcv2,41747956,36734104,88,5013852
"GVAP Indicator",mic_nongavi,2015,mcv2,41990928,37341569,89,4649359
"GVAP Indicator",mic_nongavi,2016,mcv2,42415704,38072323,90,4343381
"GVAP Indicator",mic_nongavi,2017,mcv2,42701985,37661963,88,5040022
"GVAP Indicator",mic_nongavi,2000,mcv2x2,38943780,3719515,10,35224265
"GVAP Indicator",mic_nongavi,2001,mcv2x2,39281453,4096252,10,35185201
"GVAP Indicator",mic_nongavi,2002,mcv2x2,39788332,4003673,10,35784659
"GVAP Indicator",mic_nongavi,2003,mcv2x2,38216059,3663027,10,34553032
"GVAP Indicator",mic_nongavi,2004,mcv2x2,38431214,4038228,11,34392986
"GVAP Indicator",mic_nongavi,2005,mcv2x2,38671306,16267972,42,22403334
"GVAP Indicator",mic_nongavi,2006,mcv2x2,39260619,18396625,47,20863994
"GVAP Indicator",mic_nongavi,2007,mcv2x2,39878395,18707867,47,21170528
"GVAP Indicator",mic_nongavi,2008,mcv2x2,39412760,20086652,51,19326108
"GVAP Indicator",mic_nongavi,2009,mcv2x2,39759157,21544123,54,18215034
"GVAP Indicator",mic_nongavi,2010,mcv2x2,40190506,21712091,54,18478415
"GVAP Indicator",mic_nongavi,2011,mcv2x2,40555041,22543205,56,18011836
"GVAP Indicator",mic_nongavi,2012,mcv2x2,40937638,22653844,55,18283794
"GVAP Indicator",mic_nongavi,2013,mcv2x2,41816827,23540131,56,18276696
"GVAP Indicator",mic_nongavi,2014,mcv2x2,42237688,27407646,65,14830042
"GVAP Indicator",mic_nongavi,2015,mcv2x2,42476062,27908894,66,14567168
"GVAP Indicator",mic_nongavi,2016,mcv2x2,42883023,28743168,67,14139855
"GVAP Indicator",mic_nongavi,2017,mcv2x2,43106867,27782536,64,15324331
"GVAP Indicator",mic_nongavi,2008,pcv3,40689911,322034,1,40367877
"GVAP Indicator",mic_nongavi,2009,pcv3,41143864,2505400,6,38638464
"GVAP Indicator",mic_nongavi,2010,pcv3,41570059,5608049,13,35962010
"GVAP Indicator",mic_nongavi,2011,pcv3,41917585,8130807,19,33786778
"GVAP Indicator",mic_nongavi,2012,pcv3,42151245,9493393,23,32657852
"GVAP Indicator",mic_nongavi,2013,pcv3,42247377,9636718,23,32610659
"GVAP Indicator",mic_nongavi,2014,pcv3,42194729,10984094,26,31210635
"GVAP Indicator",mic_nongavi,2015,pcv3,41993649,11113171,26,30880478
"GVAP Indicator",mic_nongavi,2016,pcv3,41660425,12337565,30,29322860
"GVAP Indicator",mic_nongavi,2017,pcv3,41237463,14059028,34,27178435
"GVAP Indicator",mic_nongavi,1980,pol3,40870276,9894027,24,30976249
"GVAP Indicator",mic_nongavi,1981,pol3,41611591,9749357,23,31862234
"GVAP Indicator",mic_nongavi,1982,pol3,42670422,28237089,66,14433333
"GVAP Indicator",mic_nongavi,1983,pol3,43935120,29733625,68,14201495
"GVAP Indicator",mic_nongavi,1984,pol3,45288558,32710819,72,12577739
"GVAP Indicator",mic_nongavi,1985,pol3,46541409,35201175,76,11340234
"GVAP Indicator",mic_nongavi,1986,pol3,47487562,32013742,67,15473820
"GVAP Indicator",mic_nongavi,1987,pol3,47998874,36181924,75,11816950
"GVAP Indicator",mic_nongavi,1988,pol3,47998865,42246159,88,5752706
"GVAP Indicator",mic_nongavi,1989,pol3,47479353,41725995,88,5753358
"GVAP Indicator",mic_nongavi,1990,pol3,46490718,41339542,89,5151176
"GVAP Indicator",mic_nongavi,1991,pol3,45199683,39921035,88,5278648
"GVAP Indicator",mic_nongavi,1992,pol3,46149132,39955307,87,6193825
"GVAP Indicator",mic_nongavi,1993,pol3,44652315,38004971,85,6647344
"GVAP Indicator",mic_nongavi,1994,pol3,43168931,36442476,84,6726455
"GVAP Indicator",mic_nongavi,1995,pol3,41920208,34703936,83,7216272
"GVAP Indicator",mic_nongavi,1996,pol3,40942732,34738220,85,6204512
"GVAP Indicator",mic_nongavi,1997,pol3,40190527,34968734,87,5221793
"GVAP Indicator",mic_nongavi,1998,pol3,39621921,34616712,87,5005209
"GVAP Indicator",mic_nongavi,1999,pol3,39234494,34709825,88,4524669
"GVAP Indicator",mic_nongavi,2000,pol3,39017407,34607664,89,4409743
"GVAP Indicator",mic_nongavi,2001,pol3,38950462,34578058,89,4372404
"GVAP Indicator",mic_nongavi,2002,pol3,38998918,34465384,88,4533534
"GVAP Indicator",mic_nongavi,2003,pol3,39129286,34858980,89,4270306
"GVAP Indicator",mic_nongavi,2004,pol3,39318941,35190658,90,4128283
"GVAP Indicator",mic_nongavi,2005,pol3,39564576,35596486,90,3968090
"GVAP Indicator",mic_nongavi,2006,pol3,39876221,37200152,93,2676069
"GVAP Indicator",mic_nongavi,2007,pol3,40256332,37624648,93,2631684
"GVAP Indicator",mic_nongavi,2008,pol3,40689911,38954607,96,1735304
"GVAP Indicator",mic_nongavi,2009,pol3,41143864,39256963,95,1886901
"GVAP Indicator",mic_nongavi,2010,pol3,41570059,39391633,95,2178426
"GVAP Indicator",mic_nongavi,2011,pol3,41917585,39870093,95,2047492
"GVAP Indicator",mic_nongavi,2012,pol3,42151245,39971878,95,2179367
"GVAP Indicator",mic_nongavi,2013,pol3,42247377,39653906,94,2593471
"GVAP Indicator",mic_nongavi,2014,pol3,42194729,39355674,93,2839055
"GVAP Indicator",mic_nongavi,2015,pol3,41993649,39388868,94,2604781
"GVAP Indicator",mic_nongavi,2016,pol3,41660425,38182494,92,3477931
"GVAP Indicator",mic_nongavi,2017,pol3,41237463,38817951,94,2419512
"GVAP Indicator",mic_nongavi,1980,rcv1,40870276,0,0,40870276
"GVAP Indicator",mic_nongavi,1981,rcv1,41611591,0,0,41611591
"GVAP Indicator",mic_nongavi,1982,rcv1,42670422,0,0,42670422
"GVAP Indicator",mic_nongavi,1983,rcv1,43935120,0,0,43935120
"GVAP Indicator",mic_nongavi,1984,rcv1,45288558,0,0,45288558
"GVAP Indicator",mic_nongavi,1985,rcv1,46541409,0,0,46541409
"GVAP Indicator",mic_nongavi,1986,rcv1,47487562,3584,0,47483978
"GVAP Indicator",mic_nongavi,1987,rcv1,47998874,79494,0,47919380
"GVAP Indicator",mic_nongavi,1988,rcv1,47998865,83924,0,47914941
"GVAP Indicator",mic_nongavi,1989,rcv1,47479353,70420,0,47408933
"GVAP Indicator",mic_nongavi,1990,rcv1,46490718,80432,0,46410286
"GVAP Indicator",mic_nongavi,1991,rcv1,45199683,88516,0,45111167
"GVAP Indicator",mic_nongavi,1992,rcv1,46149132,114536,0,46034596
"GVAP Indicator",mic_nongavi,1993,rcv1,44652315,1086468,2,43565847
"GVAP Indicator",mic_nongavi,1994,rcv1,43168931,1246192,3,41922739
"GVAP Indicator",mic_nongavi,1995,rcv1,41920208,2860937,7,39059271
"GVAP Indicator",mic_nongavi,1996,rcv1,40942732,2949388,7,37993344
"GVAP Indicator",mic_nongavi,1997,rcv1,40190527,2634087,7,37556440
"GVAP Indicator",mic_nongavi,1998,rcv1,39621921,5958812,15,33663109
"GVAP Indicator",mic_nongavi,1999,rcv1,39234494,7455809,19,31778685
"GVAP Indicator",mic_nongavi,2000,rcv1,39017407,12593607,32,26423800
"GVAP Indicator",mic_nongavi,2001,rcv1,38950462,13518951,35,25431511
"GVAP Indicator",mic_nongavi,2002,rcv1,38998918,13470093,35,25528825
"GVAP Indicator",mic_nongavi,2003,rcv1,39129286,14055304,36,25073982
"GVAP Indicator",mic_nongavi,2004,rcv1,39318941,16131331,41,23187610
"GVAP Indicator",mic_nongavi,2005,rcv1,39564576,16311297,41,23253279
"GVAP Indicator",mic_nongavi,2006,rcv1,39876221,17809129,45,22067092
"GVAP Indicator",mic_nongavi,2007,rcv1,40256332,18118340,45,22137992
"GVAP Indicator",mic_nongavi,2008,rcv1,40689911,17840998,44,22848913
"GVAP Indicator",mic_nongavi,2009,rcv1,41143864,18092676,44,23051188
"GVAP Indicator",mic_nongavi,2010,rcv1,41570059,30517326,73,11052733
"GVAP Indicator",mic_nongavi,2011,rcv1,41917585,35142990,84,6774595
"GVAP Indicator",mic_nongavi,2012,rcv1,42151245,36919255,88,5231990
"GVAP Indicator",mic_nongavi,2013,rcv1,42247377,36767764,87,5479613
"GVAP Indicator",mic_nongavi,2014,rcv1,42194729,37530788,89,4663941
"GVAP Indicator",mic_nongavi,2015,rcv1,41993649,36978766,88,5014883
"GVAP Indicator",mic_nongavi,2016,rcv1,41660425,37360147,90,4300278
"GVAP Indicator",mic_nongavi,2017,rcv1,41237463,38184395,93,3053068
"GVAP Indicator",mic_nongavi,2006,rotac,39876221,1567739,4,38308482
"GVAP Indicator",mic_nongavi,2007,rotac,40256332,2720915,7,37535417
"GVAP Indicator",mic_nongavi,2008,rotac,40689911,4214654,10,36475257
"GVAP Indicator",mic_nongavi,2009,rotac,41143864,6295509,15,34848355
"GVAP Indicator",mic_nongavi,2010,rotac,41570059,7187587,17,34382472
"GVAP Indicator",mic_nongavi,2011,rotac,41917585,8437671,20,33479914
"GVAP Indicator",mic_nongavi,2012,rotac,42151245,9250559,22,32900686
"GVAP Indicator",mic_nongavi,2013,rotac,42247377,9933726,24,32313651
"GVAP Indicator",mic_nongavi,2014,rotac,42194729,9212543,22,32982186
"GVAP Indicator",mic_nongavi,2015,rotac,41993649,9696240,23,32297409
"GVAP Indicator",mic_nongavi,2016,rotac,41660425,9253785,22,32406640
"GVAP Indicator",mic_nongavi,2017,rotac,41237463,8655896,21,32581567
"GVAP Indicator",mic_nongavi,1997,yfv,5918922,0,0,5918922
"GVAP Indicator",mic_nongavi,1998,yfv,5895182,1328660,23,4566522
"GVAP Indicator",mic_nongavi,1999,yfv,5862840,1317661,22,4545179
"GVAP Indicator",mic_nongavi,2000,yfv,5821674,1429023,25,4392651
"GVAP Indicator",mic_nongavi,2001,yfv,5772185,1650062,29,4122123
"GVAP Indicator",mic_nongavi,2002,yfv,5716998,1051473,18,4665525
"GVAP Indicator",mic_nongavi,2003,yfv,5659183,1887892,33,3771291
"GVAP Indicator",mic_nongavi,2004,yfv,5601276,1908892,34,3692384
"GVAP Indicator",mic_nongavi,2005,yfv,5546812,2122243,38,3424569
"GVAP Indicator",mic_nongavi,2006,yfv,5499203,2774345,50,2724858
"GVAP Indicator",mic_nongavi,2007,yfv,5459736,2720229,50,2739507
"GVAP Indicator",mic_nongavi,2008,yfv,5428659,2695288,50,2733371
"GVAP Indicator",mic_nongavi,2009,yfv,5540697,2652032,48,2888665
"GVAP Indicator",mic_nongavi,2010,yfv,5523899,2687114,49,2836785
"GVAP Indicator",mic_nongavi,2011,yfv,5510479,2909536,53,2600943
"GVAP Indicator",mic_nongavi,2012,yfv,5496866,3214025,58,2282841
"GVAP Indicator",mic_nongavi,2013,yfv,5480100,3326669,61,2153431
"GVAP Indicator",mic_nongavi,2014,yfv,5447599,3381880,62,2065719
"GVAP Indicator",mic_nongavi,2015,yfv,5420586,3305011,61,2115575
"GVAP Indicator",mic_nongavi,2016,yfv,5388131,3122564,58,2265567
"GVAP Indicator",mic_nongavi,2017,yfv,5351943,3515675,66,1836268
